OLIGO	REP_SEQ
Actinobacteria_CAA-AA----CGAAAG-C--C	CAAGGCAATGATGGGTAGCTGGGTTGAGAGACCGACCAGCCAGATTGGGACTGAGACACGGCCCAGACTCCTACGGGAGGCAGCAGTGGGGAATCTTGCACAATGGGCGAAAGCCTGATGCAGCGACGCCGCGTGCGGGATG-AAGGCCTTCGGGTTGTAAACCGCTTTCAGCAGGGACGA--GG---------C--G-AAAG----------TGACGGTAC-CT-G-CA-GAA---GAAGCCCCGGCTAACTACGTG
Actinobacteria_CAC-AAAC----CTG--C--A	--------CGACGGGTAGCCGGCCTGAGAGGGTGGACGGCCACATTGGGACTGAGACACGGCCCAGACTCCTACGGGAGGCAGCAGTGGGGAATATTGCACAATGGGCGCAAGCCTGATGCAGCGACGCCGCGTGGGGGATG-AAGGCCTTCGGGTTGTAAACTCCTTTCGCCCGGGACGAAGCCCA-C----------CTG------GTGGGTGACGGTAC-CGTG-GA-GAA---GAAGCACCGGCTAACTACGTG
Actinobacteria_CAC-CA------AAAG-G--G	CAAGGCGACGACGGGTAGCCGGCCTGAGAGGGTGACCGGCCACACTGGGACTGAGACACGGCCCAGACTCCTACGGGAGGCAGCAGTGGGGAATATTGCACAATGGGCGCAAGCCTGATGCAGCGACGCCGCGTGAGGGATG-ACGGCCTTCGGGTTGTAAACCTCTGTTAGCATCGAAGAAGCG--------------AAAG----------TGACGGTAG-GT-G-CA-GAG---AAAGCGCCGGCTAACTACGTG
Actinobacteria_CAC-CA------AAAT-C--G	CAAGGCGACGACGGGTAGCCGGCCTGAGAGGGTGACCGGCCACACTGGGACTGAGACACGGCCCAGACTCCTACGGGAGGCAGCAGTGGGGAATATTGCACAATGGGCGCAAGCCTGATGCAGCGACGCCGCGTGAGGGATG-ACGGCCTTCGGGTTGTAAACCTCTGTTAGCAGGGAAGAAGAG--------------AAAT----------TGACGGTAC-CT-G-CA-GAG---AAAGCGCCGGCTAACTACGTG
Actinobacteria_CAC-CA------AGAT-C--G	CAAGGCGACGACGGGTAGCCGGCCTGAGAGGGTGACCGGCCACACTGGGACTGAGACACGGCCCAGACTCCTACGGGAGGCAGCAGTGGGGAATATTGCACAATGGGCGCAAGCCTGATGCAGCGACGCCGCGTGAGGGATG-ACGGCCTTCGGGTTGTAAACCTCTGTTAGCAGGGAAGAAGAG--------------AGAT----------TGACGGTAC-CT-G-CA-GAG---AAAGCGCCGGCTAACTACGTG
Actinobacteria_CAC-CAAC----CT-G-C--A	--------CGACGGGTAGCCGGCCTGAGAGGGTGGACGGCCACATTGGGACTGAGACACGGCCCAGACTCCTACGGGAGGCAGCAGTGGGGAATATTGCACAATGGGCGCAAGCCTGATGCAGCGACGCCGCGTGGGGGATG-ACGGCCTTCGGGTTGTAAACTCCTTTCGCCCGGGACGAAGCCCA-C----------CT-G-----GTGGGTGACGGTAC-CGTG-GA-GAA---GAAGCACCGGCTAACTACGTG
Actinobacteria_CAC-CAAC----CTTG-C--A	---------GACGGGTAGCCGGCCTGAGAGGGTGGACGGCCACATTGGGACTGAGACACGGCCCAGACTCCTACGGGAGGCAGCAGTGGGGAATATTGCACAATGGGCGCAAGCCTGATGCAGCGACGCCGCGTGGGGGATG-ACGGCCTTCGGGTTGTAAACTCCTTTCGCCCGGGACGAAGCCCA-C----------CTTG-----GTGGGTGACGGTAC-CGTG-GA-GAA---GAAGCACCGGCTAACTACGTG
Actinobacteria_CAC-CACAC--TTTTTGT--A	--------------GTAGCCGGCCTGAGAGGGTGGACGGCCACATTGGGACTGAGATACGGCCCAGACTCCTACGGGAGGCAGCAGTGGGGAATATTGCACAATGGGCGCAAGCCTGATGCAGCGACGCCGCGTGGGGGATG-ACGGCCTTCGGGTTGTAAACTCCTTTCGTTAGGGACGAAGCCAC-AC-------T-TTTT--GGGTGTGGTGACGGTACCTT-T-GT-TAA---GAAGCACCGGCTAACTACGTG
Actinobacteria_CAC-CACACC-GTTTTGT--A	----------------AGCCGGCCTGAGAGGGTGGACGGCCACATTGGGACTGAGATACGGCCCAGACTCCTACGGGAGGCAGCAGTGGGGAATATTGCACAATGGGCGCAAGCCTGATGCAGCGACGCCGCGTGGGGGATG-ACGGCCTTCGGGTTGTAAACTCCTTTCGTTAGGGACGAAGCCGC-ACCT-----G-TTTT--GGGTGTGGTGACGGTACCTT-T-GT-TAA---GAAGCACCGGCTAACTACGTG
Actinobacteria_CAC-CACACC-TTTT-GT--A	---------------TAGCCGGCCTGAGAGGGTGGACGGCCACATTGGGACTGAGATACGGCCCAGACTCCTACGGGAGGCAGCAGTGGGGAATATTGCACAATGGGCGCAAGCCTGATGCAGCGACGCCGCGTGGGGGATG-ACGGCCTTCGGGTTGTAAACTCCTTTCGTTAGGGACGAAGCCAC-ACCT-----T-TTT---GGGTGTGGTGACGGTACCTT-T-GT-TAA---GAAGCACCGGCTAACTACGTG
Actinobacteria_CAC-CACACC-TTTTTGCT-A	----------------AGCCGGCCTGAGAGGGTGGACGGCCACATTGGGACTGAGATACGGCCCAGACTCCTACGGGAGGCAGCAGTGGGGAATATTGCACAATGGGCGCAAGCCTGATGCAGCGACGCCGCGTGGGGGATG-ACGGCCTTCGGGTTGTAAACTCCTTTCGTTAGGGACGAAGCCAC-ACCT-----T-TTTT--GGGTGTGGTGACGGTAC-CT-TTGT-TAA---GAAGCACCGGCTAACTACGTG
Actinobacteria_CAC-CACACC-TTTTTGT--A	----------------AGCCGGCCTGAGAGGGTGGACGGCCACATTGGGACTGAGATACGGCCCAGACTCCTACGGGAGGCAGCAGTGGGGAATATTGCACAATGGGCGCAAGCCTGATGCAGCGACGCCGCGTGGGGGATG-ACGGCCTTCGGGTTGTAAACTCCTTTCGTTAGGGACGAAGCCGC-ACCT-----T-TTTT--GGGTGTGGTGACGGTACCTT-T-GT-TAA---GAAGCACCGGCTAACTACGTG
Actinobacteria_CAC-CACACCTTTTTTGT--A	-----------------GCCGGCCTGAGAGGGTGGACGGCCACATTGGGACTGAGATACGGCCCAGACTCCTACGGGAGGCAGCAGTGGGGAATATTGCACAATGGGCGCAAGCCTGATGCAGCGACGCCGCGTGGGGGATG-ACGGCCTTCGGGTTGTAAACTCCTTTCGTTAGGGACGAAGCCGC-ACCT--T--T-TTTT--GGGTGTGGTGACGGTACCTT-T-GT-TAA---GAAGCACCGGCTAACTACGTG
Actinobacteria_CAC-CACACT-TTTTTGCT-A	----------------AGCCGGCCTGAGAGGGTGGACGGCCACATTGGGACTGAGATACGGCCCAGACTCCTACGGGAGGCAGCAGTGGGGAATATTGCACAATGGGCGCAAGCCTGATGCAGCGACGCCGCGTGGGGGATG-ACGGCCTTCGGGTTGTAAACTCCTTTCGTTAGGGACGAAGCCAC-ACTT-----T-TTTT--GGGTGTGGTGACGGTAC-CT-TTGT-TAA---GAAGCACCGGCTAACTACGTG
Actinobacteria_CAC-CACACT-TTTTTGT--A	----------------AGCCGGCCTGAGAGGGTGGACGGCCACATTGGGACTGAGATACGGCCCAGACTCCTACGGGAGGCAGCAGTGGGGAATATTGCACAATGGGCGCAAGCCTGATGCAGCGACGCCGCGTGGGGGATG-ACGGCCTTCGGGTTGTAAACTCCTTTCGTTAGGGACGAAGCCGC-ACTT-----T-TTTT--GGGTGTGGTGACGGTACCTT-T-GT-TAA---GAAGCACCGGCTAACTACGTG
Actinobacteria_CAC-CACCCT-TTTTTGT--A	-----------------GCCGGCCTGAGAGGGTGGACGGCCACATTGGGACTGAGATACGGCCCAGACTCCTACGGGAGGCAGCAGTGGGGAATATTGCACAATGGGCGCAAGCCTGATGCAGCGACGCCGCGTGGGGGATG-ACGGCCTTCGGGTTGTAAACTCCTTTCGTTAGGGACGAAGCCACACCTT-----T-TTTT--GGGTGTGGTGACGGTACCTT-T-GT-TAA---GAAGCACCGGCTAACTACGTG
Actinobacteria_CAC-CACGCC-TTTTTGT--A	----------------AGCCGGCCTGAGAGGGTGGACGGCCACATTGGGACTGAGATACGGCCCAGACTCCTACGGGAGGCAGCAGTGGGGAATATTGCACAATGGGCGCAAGCCTGATGCAGCGACGCCGCGTGGGGGATG-ACGGCCTTCGGGTTGTAAACTCCTTTCGTTAGGGACGAAGCCAC-GCCT-----T-TTTT--GGGTGTGGTGACGGTACCTT-T-GT-TAA---GAAGCACCGGCTAACTACGTG
Actinobacteria_CAC-CACGCT-TTTTGGCT-A	--------------GTAGCCGGCCTGAGAGGGTGGACGGCCACATTGGGACTGAGATACGGCCCAGACTCCTACGGGAGGCAGCAGTGGGGAATATTGCACAATGGGCGCAAGCCTGATGCAGCGACGCCGCGTGGGGGATG-ACGGCCTTCGGGTTGTAAACTCCTTTCGTTAGGGACGAAGCCAC-GCT------T-TTTG---GGTGTGGTGACGGTAC-CT-TTGT-TAA---GAAGCACCGGCTAACTACGTG
Actinobacteria_CAC-CACTGC-TGGT-GC--G	--------------GTAGCCGGCCTGAGAGGGTGACCGGCCACACTGGGACTGAGATACGGCCCAGACTCCTACGGGAGGCAGCAGTGGGGGATATTGCACAATGGGCGCAAGCCTGATGCAGCGACGCCGCGTGGGGGATG-ACGGCTTTCGGGTTGTAAACCTCTTTCGTCGGGGGACAAGGCTC-TGCT-----T-GGT---GGTGGGGTTGAGGGTAC-CC-G-GT-GAA---GAAGCGCCGGCTAACTACGTG
Actinobacteria_CAC-CATAC--TTTTTGT--A	--------------GTAGCCGGCCTGAGAGGGTGGACGGCCACATTGGGACTGAGATACGGCCCAGACTCCTACGGGAGGCAGCAGTGGGGAATATTGCACAATGGGCGCAAGCCTGATGCAGCGACGCCGCGTGGGGGATG-ACGGCCTTCGGGTTGTAAACTCCTTTCGTTAGGGACGAAGCCAT-AC-------T-TTTT--GGGTGTGGTGACGGTACCTT-T-GT-TAA---GAAGCACCGGCTAACTACGTG
Actinobacteria_CACGAAAC----CTG--C--A	---------GACGGGTAGCCGGCCTGAGAGGGTGGACGGCCACATTGGGACTGAGACACGGCCCAGACTCCTACGGGAGGCAGCAGTGGGGAATATTGCACAATGGGCGCAAGCCTGATGCAGCGACGCCGCGTGGGGGATGGAAGGCCTTCGGGTTGTAAACTCCTTTCGCCCGGGACGAAGCCCA-C----------CTG------GTGGGTGACGGTAC-CGTG-GA-GAA---GAAGCACCGGCTAACTACGTG
Actinobacteria_CACGAAAC----TTG--C--A	----------ACGGGTAGCCGGCCTGAGAGGGTGGACGGCCACATTGGGACTGAGACACGGCCCAGACTCCTACGGGAGGCAGCAGTGGGGAATATTGCACAATGGGCGCAAGCCTGATGCAGCGACGCCGCGTGGGGGATGGAAGGCCTTCGGGTTGTAAACTCCTTTCGCCCGGGACGAAGCCCA-C---------CTTG------GTGGGTGACGGTAC-CGTG-GA-GAA---GAAGCACCGGCTAACTACGTG
Actinobacteria_CAG-CA------TGAG-T--A	CAAGGCTTTGACGGGTAGCCGGCCTGAGAGGGTGACCGGCCACATTGGGACTGAGATACGGCCCAGACTCCTACGGGAGGCAGCAGTGGGGAATATTGCACAATGGGCGGAAGCCTGATGCAGCAACGCCGCGTGCGGGATG-ACGGCCTTCGGGTTGTAAACCGCTTTCGCCTGTGACGAAGCG--------------TGAG----------TGACGGTAA-TG-G-GT-AAA---GAAGCACCGGCTAACTACGTG
Actinobacteria_CAG-CA-----TTTTG-C--A	CAAGGCGTCGACGGGTAGCCGGCCTGAGAGGGTGTACGGCCACATTGGGACTGAGACACGGCCCAGACTCCTACGGGAGGCAGCAGTGGGGAATATTGCACAATGGGCGGAAGCCTGATGCAGCGACGCCGCGTGAGGGATG-ACGGCCTTCGGGTTGTAAACCTCTTTCGACAGGGACGAAG-C------------T-TTTG----------TGACGGTAC-CT-G-TA-TAA---GAAGCACCGGCTAACTACGTG
Actinobacteria_CAG-CA-----TTTTG-T--A	CAAGGCTTCGACGGGTAGCCGGCCTGAGAGGGCGACCGGCCACATTGGGACTGAGATACGGCCCAAACTCCTACGGGAGGCAGCAGTGGGGAATATTGCACAATGGACGGAAGTCTGATGCAGCAACGCCGCGTGCGGGATG-ACGGCCTTCGGGTTGTAAACCGCTTTCATCCATGACGAAG-C------------T-TTTG----------TGACGGTAG-TG-G-GT-AAA---GAAGCACCGGCTAACTACGTG
Actinobacteria_CAG-CA----TTTT-G-C--A	-AAGGCTTCGACGGGTAGCCGGCCTGAGAGGGCGACCGGCCACATTGGGACTGAGATACGGCCCAAACTCCTACGGGAGGCAGCAGTGGGGAATATTGCACAATGGACGGAAGTCTGATGCAGCAACGCCGCGTGCGGGATG-ACGGCCTTCGGGTTGTAAACCGCTTTCAATTGTGACGAAGCT---------T--T-TT-G----------TGACGGTAG-CA-G-TA-GAA---GAAGCACCGGCTAACTACGTG
Actinobacteria_CGC-AGTCCTGTTTGTGC--G	-----------------GCCGGCCTGAGAGGGTGGACGGCCACACTGGGACTGAGACACGGCCCAGACTCCTGCGGGAGGCAGCAGTGGGGAATATTGCACAATGGGCGCAAGCCTGATGCAGCGACGCCGCGTGAGGGATG-GAGGCCTTCGGGTTGTGAACCTCTTTCGCCAGTGAAGCAGGCCTGCCTC--G--T-TTGT--GGGTGGGTTGACGGTAG-CT-G-GA-TAA---GAAGCGCCGGCTAACTACGTG
Actinobacteria_CGC-AGTGCTCTGTGTGC--G	----------------AGCCGGCCTGAGAGGGTGGACGGCCACACTGGGACTGAGACACGGCCCAGACTCCTGCGGGAGGCAGCAGTGGGGAATATTGCACAATGGGCGCAAGCCTGATGCAGCGACGCCGCGTGAGGGATG-GAGGCCTTCGGGTTGTGAACCTCTTTCGCCAGTGAAGCAGGCCT-GCTC--C--T-GTGT--GGGTGGGTTGACGGTAG-CT-G-GA-TAA---GAAGCGCCGGCTAACTACGTG
Actinobacteria_TAA-AAC-GA-TTTTGGT--G	------------GGGTAGCCGGCCTGAGAGGGTGACCGGTCACATTGGGACTGAGATACGGCCCAGACTCCTACGGGAGGCAGCAGTGGGGAATATTGCACAATGGGCGAAAGCCTGATGCAGCGACGCCGCGTGAGGGATG-GAGGCCTTCGGGTTGTAAACCTCTTTCGCTCATGGTCAAGCCGC--GA------T-TTTG---GTTGTGGTGAGGGTAG-TG-G-GT-AAA---GAAGCGCCGGCTAACTACGTG
Actinobacteria_TAA-AACAAC--AATGGT--G	------------GGGTAGCCGGCCTGAGAGGGTGACCGGTCACATTGGGACTGAGATACGGCCCAGACTCCTACGGGAGGCAGCAGTGGGGAATATTGCACAATGGGCGAAAGCCTGATGCAGCGACGCCGCGTGAGGGATG-GAGGCCTTCGGGTTGTAAACCTCTTTCGCTCATGGTCAAGCCGC-AAC--------AATG---GTTGTGGTGAGGGTAG-TG-G-GT-AAA---GAAGCGCCGGCTAACTACGTG
Actinobacteria_TAA-AACAAC--AGTGGT--A	------------GGGTAACCGGCCTGAGAGGGTGACCGGTCACATTGGGACTGAGATACGGCCCAGACTCCTACGGGAGGCAGCAGTGGGGAATATTGCACAATGGGCGAAAGCCTGATGCAGCGACGCCGCGTGAGGGATG-GAGGCCTTCGGGTTGTAAACCTCTTTCGCTCATGGTCAAGCCGC-AAC--------AGTG---GTTGTGGTGAGGGTAG-TG-G-GT-AAA---GAAGCACCGGCTAACTACGTG
Actinobacteria_TAA-AACAAC--AGTGGT--G	------------GGGTAGCCGGCCTGAGAGGGTGACCGGTCACATTGGGACTGAGATACGGCCCAGACTCCTACGGGAGGCAGCAGTGGGGAATATTGCACAATGGGCGAAAGCCTGATGCAGCGACGCCGCGTGAGGGATG-GAGGCCTTCGGGTTGTAAACCTCTTTCGCTCATGGTCAAGCCGC-AAC--------AGTG---GTTGTGGTGAGGGTAG-TG-G-GT-AAA---GAAGCGCCGGCTAACTACGTG
Actinobacteria_TAA-AACAAC--ATTGGT--G	------------GGGTAGCCGGCCTGAGAGGGTGACCGGTCACATTGGGACTGAGATACGGCCCAGACTCCTACGGGAGGCAGCAGTGGGGAATATTGCACAATGGGCGAAAGCCTGATGCAGCGACGCCGCGTGAGGGATG-GAGGCCTTCGGGTTGTAAACCTCTTTCGCTCATGGTCAAGCCGC-AAC--------ATTG---GTTGTGGTGAGGGTAG-TG-G-GT-AAA---GAAGCGCCGGCTAACTACGTG
Actinobacteria_TAA-AACAAC-GTTTGGT--G	-------------GGTAGCCGGCCTGAGAGGGTGACCGGTCACATTGGGACTGAGATACGGCCCAGACTCCTACGGGAGGCAGCAGTGGGGAATATTGCACAATGGGCGAAAGCCTGATGCAGCGACGCCGCGTGAGGGATG-GAGGCCTTCGGGTTGTAAACCTCTTTCGCTCATGGTCAAGCCGC-AAC------G-TTTG---GTTGTGGTGAGGGTAG-TG-G-GT-AAA---GAAGCGCCGGCTAACTACGTG
Actinobacteria_TAA-AACAAC-T-TGGGT--G	------------GGGTAGCCGGCCTGAGAGGGTGACCGGTCACATTGGGACTGAGATACGGCCCAGACTCCTACGGGAGGCAGCAGTGGGGAATATTGCACAATGGGCGAAAGCCTGATGCAGCGACGCCGCGTGAGGGATG-GAGGCCTTCGGGTTGTAAACCTCTTTCGCTCATGGTCAAGCCGC-AAC------T--TGG---GTTGTGGTGAGGGTAG-TG-G-GT-AAA---GAAGCGCCGGCTAACTACGTG
Actinobacteria_TAA-AACAAC-TCAAGGT--A	-------------GGTAACCGGCCTGAGAGGGTGACCGGTCACATTGGGACTGAGATACGGCCCAGACTCCTACGGGAGGCAGCAGTGGGGAATATTGCACAATGGGCGAAAGCCTGATGCAGCGACGCCGCGTGAGGGATG-AAGGCCTTCGGGTTGTAAACCTCTTTCGCTCATGGTCAAGCCGC-AAC------T-CAAG---GTTGTGGTGAGGGTAG-TG-G-GT-AAA---GAAGCACCGGCTAACTACGTG
Actinobacteria_TAA-AACAAC-TGTGGGT--G	-------------GGTAGCCGGCCTGAGAGGGTGACCGGTCACATTGGGACTGAGATACGGCCCAGACTCCTACGGGAGGCAGCAGTGGGGAATATTGCACAATGGGCGAAAGCCTGATGCAGCGACGCCGCGTGAGGGATG-GAGGCCTTCGGGTTGTAAACCTCTTTCGCTCATGGTCAAGCCGC-AAC------T-GTGG---GTTGTGGTGAGGGTAG-TG-G-GT-AAA---GAAGCGCCGGCTAACTACGTG
Actinobacteria_TAA-AACAAC-TTAGGGT--G	-------------GGTAGCCGGCCTGAGAGGGTGACCGGTCACATTGGGACTGAGATACGGCCCAGACTCCTACGGGAGGCAGCAGTGGGGAATATTGCACAATGGGCGAAAGCCTGATGCAGCGACGCCGCGTGAGGGATG-GAGGCCTTCGGGTTGTAAACCTCTTTCGCTCATGGTCAAGCCGC-AAC------T-TAGG---GTTGTGGTGAGGGTAG-TG-G-GT-AAA---GAAGCGCCGGCTAACTACGTG
Actinobacteria_TAA-AACAAC-TTTGGGT--A	-------------GGTAACCGGCCTGAGAGGGTGACCGGTCACATTGGGACTGAGATACGGCCCAGACTCCTACGGGAGGCAGCAGTGGGGAATATTGCACAATGGGCGAAAGCCTGATGCAGCGACGCCGCGTGAGGGATG-AAGGCCTTCGGGTTGTAAACCTCTTTCGCTCATGGTCAAGCCGC-AAC------T-TTGG---GTTGTGGTGAGGGTAG-TG-G-GT-AAA---GAAGCACCGGCTAACTACGTG
Actinobacteria_TAA-AACAGC-TTTGGGT--G	-------------GGTAGCCGGCCTGAGAGGGTGACCGGTCACATTGGGACTGAGATACGGCCCAGACTCCTACGGGAGGCAGCAGTGGGGAATATTGCACAATGGGCGAAAGCCTGATGCAGCGACGCCGCGTGAGGGATG-GAGGCCTTCGGGTTGTAAACCTCTTTCGCTCATGGTCAAGCCGC-AGC------T-TTGG---GTTGTGGTGAGGGTAG-TG-G-GT-AAA---GAAGCGCCGGCTAACTACGTG
Actinobacteria_TAA-AACGAC--ATTGGT--G	------------GGGTAGCCGGCCTGAGAGGGTGACCGGTCACATTGGGACTGAGATACGGCCCAGACTCCTACGGGAGGCAGCAGTGGGGAATATTGCACAATGGGCGAAAGCCTGATGCAGCGACGCCGCGTGAGGGATG-GAGGCCTTCGGGTTGTAAACCTCTTTCGCTCATGGTCAAGCCGC-GAC--------ATTG---GTTGTGGTGAGGGTAG-TG-G-GT-AAA---GAAGCGCCGGCTAACTACGTG
Actinobacteria_TAA-AACGAC--GTGGGT--G	------------GGGTAGCCGGCCTGAGAGGGTGACCGGTCACATTGGGACTGAGATACGGCCCAGACTCCTACGGGAGGCAGCAGTGGGGAATATTGCACAATGGGCGAAAGCCTGATGCAGCGACGCCGCGTGAGGGATG-GAGGCCTTCGGGTTGTAAACCTCTTTCGCTCATGGTCAAGCCGC-GAC--------GTGG---GTTGTGGTGAGGGTAG-TG-G-GT-AAA---GAAGCGCCGGCTAACTACGTG
Actinobacteria_TAA-AACGAC-T-TTGGT--G	------------GGGTAGCCGGCCTGAGAGGGTGACCGGTCACATTGGGACTGAGATACGGCCCAGACTCCTACGGGAGGCAGCAGTGGGGAATATTGCACAATGGGCGAAAGCCTGATGCAGCGACGCCGCGTGAGGGATG-GAGGCCTTCGGGTTGTAAACCTCTTTCGCTCATGGTCAAGCCGC-GAC------T--TTG---GTTGTGGTGAGGGTAG-TG-G-GT-AAA---GAAGCGCCGGCTAACTACGTG
Actinobacteria_TAA-CACAAC--AATGGT--G	------------GGGTAGCCGGCCTGAGAGGGTGACCGGTCACATTGGGACTGAGATACGGCCCAGACTCCTACGGGAGGCAGCAGTGGGGAATATTGCACAATGGGCGAAAGCCTGATGCAGCGACGCCGCGTGAGGGATG-ACGGCCTTCGGGTTGTAAACCTCTTTCGCTCATGGTCAAGCCGC-AAC--------AATG---GTTGTGGTGAGGGTAG-TG-G-GT-AAA---GAAGCGCCGGCTAACTACGTG
Actinobacteria_TAA-CACAAC--AGTGGT--A	------------GGGTAACCGGCCTGAGAGGGTGACCGGTCACATTGGGACTGAGATACGGCCCAGACTCCTACGGGAGGCAGCAGTGGGGAATATTGCACAATGGGCGAAAGCCTGATGCAGCGACGCCGCGTGAGGGATG-ACGGCCTTCGGGTTGTAAACCTCTTTCGCTCATGGTCAAGCCGC-AAC--------AGTG---GTTGTGGTGAGGGTAG-TG-G-GT-AAA---GAAGCACCGGCTAACTACGTG
Actinobacteria_TAA-CACAAC--AGTGGT--G	------------GGGTAGCCGGCCTGAGAGGGTGACCGGTCACATTGGGACTGAGATACGGCCCAGACTCCTACGGGAGGCAGCAGTGGGGAATATTGCACAATGGGCGAAAGCCTGATGCAGCGACGCCGCGTGAGGGATG-ACGGCCTTCGGGTTGTAAACCTCTTTCGCTCATGGTCAAGCCGC-AAC--------AGTG---GTTGTGGTGAGGGTAG-TG-G-GT-AAA---GAAGCGCCGGCTAACTACGTG
Actinobacteria_TAA-CACAAC--CTTGGT--G	-------------GGTAGCCGGCCTGAGAGGGTGACCGGTCACATTGGGACTGAGATACGGCCCAGACTCCTACGGGAGGCAGCAGTGGGGAATATTGCACAATGGGCGAAAGCCTGATGCAGCGACGCCGCGTGAGGGATG-ACGGCCTTCGGGTTGTAAACCTCTTTCGCTCATGGTCAAGCCGC-AAC-------ACTTG---GTTGTGGTGAGGGTAG-TG-G-GT-AAA---GAAGCGCCGGCTAACTACGTG
Actinobacteria_TAA-CACAAC-TGT-GGT--G	------------GGGTAGCCGGCCTGAGAGGGTGACCGGTCACATTGGGACTGAGATACGGCCCAGACTCCTACGGGAGGCAGCAGTGGGGAATATTGCACAATGGGCGAAAGCCTGATGCAGCGACGCCGCGTGAGGGATG-ACGGCCTTCGGGTTGTAAACCTCTTTCGCTCATGGTCAAGCCGC-AAC------T-GT-G---GTTGTGGTGAGGGTAG-TG-G-GT-AAA---GAAGCGCCGGCTAACTACGTG
Actinobacteria_TAA-CACAAC-TGTGGGT--G	-------------GGTAGCCGGCCTGAGAGGGTGACCGGTCACATTGGGACTGAGATACGGCCCAGACTCCTACGGGAGGCAGCAGTGGGGAATATTGCACAATGGGCGAAAGCCTGATGCAGCGACGCCGCGTGAGGGATG-ACGGCCTTCGGGTTGTAAACCTCTTTCGCTCATGGTCAAGCCGC-AAC------T-GTGG---GTTGTGGTGAGGGTAG-TG-G-GT-AAA---GAAGCGCCGGCTAACTACGTG
Actinobacteria_TAA-CACAGC-TTTGGGT--G	-------------GGTAGCCGGCCTGAGAGGGTGACCGGTCACATTGGGACTGAGATACGGCCCAGACTCCTACGGGAGGCAGCAGTGGGGAATATTGCACAATGGGCGAAAGCCTGATGCAGCGACGCCGCGTGAGGGATG-ACGGCCTTCGGGTTGTAAACCTCTTTCGCTCATGGTCAAGCCGC-AGC------T-TTGG---GTTGTGGTGAGGGTAG-TG-G-GT-AAA---GAAGCGCCGGCTAACTACGTG
Actinobacteria_TAC-AA-CTGCTTGT-TC--G	---------------TAGCCGGCCTGAGAGGGTGGACGGTCACACTGGGACTGAGACACGGCCCAGACTCCTACGGGAGGCAGCAGTGGGGAATATTGCACAATGGGCGCAAGCCTGATGCAGCGACGCCGCGTGAGGGATG-GAGGCCTTCGGGTTGTAAACCTCTTTCGCCAGTGAAGCAGGC---CTGCTCC--T-TGT-GGGTGG--GTTGACGGTAG-CT-G-GA-TAA---GAAGCGCCGGCTAACTACGTG
Actinobacteria_TAC-AA-TTGCTTGT-TC--G	---------------TAGCCGGCCTGAGAGGGTGGACGGTCACACTGGGACTGAGACACGGCCCAGACTCCTACGGGAGGCAGCAGTGGGGAATATTGCACAATGGGCGCAAGCCTGATGCAGCGACGCCGCGTGAGGGATG-GAGGCCTTCGGGTTGTAAACCTCTTTCGCCAGTGAAGCAGGC---TTGCTCC--T-TGT-GGGTGG--GTTGACGGTAG-CT-G-GA-TAA---GAAGCGCCGGCTAACTACGTG
Actinobacteria_TAC-AACAAC-TGTGGGT--G	-------------GGTAGCCGGCCTGAGAGGGTGACCGGTCACATTGGGACTGAGATACGGCCCAGACTCCTACGGGAGGCAGCAGTGGGGAATATTGCACAATGGGCGCAAGCCTGATGCAGCGACGCCGCGTGAGGGATG-GAGGCCTTCGGGTTGTAAACCTCTTTCGCTCATGGTCAAGCCGC-AAC------T-GTGG---GTTGTGGTGAGGGTAG-TG-G-GT-AAA---GAAGCGCCGGCTAACTACGTG
Actinobacteria_TAC-AACCGT-TTTT-GC--G	--------------GTAGCCGGCCTGAGAGGGTGGACGGTCACACTGGGACTGAGATACGGCCCAGACTCCTACGGGAGGCAGCAGTGGGGAATATTGCACAATGGGCGCAAGCCTGATGCAGCGACGCCGCGTGAGGGATG-AAGGCCTTCGGGTTGTAAACCTCTTTCGTCAGGGAACAAGGCAC-CGTC-----T-TTT---GGTGGTGTTGAGGGTAC-CT-G-GA-TAA---GAAGCGCCGGCTAACTACGTG
Actinobacteria_TAC-AACGAC--GTGGGT--G	------------GGGTAGCCGGCCTGAGAGGGTGACCGGTCACATTGGGACTGAGATACGGCCCAGACTCCTACGGGAGGCAGCAGTGGGGAATATTGCACAATGGGCGCAAGCCTGATGCAGCGACGCCGCGTGAGGGATG-GAGGCCTTCGGGTTGTAAACCTCTTTCGCTCATGGTCAAGCCGC-GAC--------GTGG---GTTGTGGTGAGGGTAG-TG-G-GT-AAA---GAAGCGCCGGCTAACTACGTG
Actinobacteria_TAC-AACTAC-TTTTGGC--G	--------------GTAGCCGGCCTGAGAGGGTGGACGGTCACACTGGGACTGAGATACGGCCCAGACTCCTACGGGAGGCAGCAGTGGGGAATATTGCACAATGGGCGCAAGCCTGATGCAGCGACGCCGCGTGAGGGATG-AAGGCCTTCGGGTTGTAAACCTCTTTCGTCAGGGAACAAGGCAC-TAC-----GT-TTTG---GTGGTGTTGAGGGTAC-CT-G-GA-TAA---GAAGCGCCGGCTAACTACGTG
Actinobacteria_TAC-AACTGC-TTT--GC--G	-------------GGTAGCCGGCCTGAGAGGGTGGACGGTCACACTGGGACTGAGATACGGCCCAGACTCCTACGGGAGGCAGCAGTGGGGAATATTGCACAATGGGCGCAAGCCTGATGCAGCGACGCCGCGTGAGGGATG-AAGGCCTTCGGGTTGTAAACCTCTTTCGTCAGGGAACAAGGCAC-TGCT-----T-TT----GGTGGTGTTGAGGGTAC-CT-G-GA-TAA---GAAGCGCCGGCTAACTACGTG
Actinobacteria_TAC-AACTGC-TTT-GGC--G	------------GGGTAGCCGGCCTGAGAGGGTGGACGGTCACACTGGGACTGAGATACGGCCCAGACTCCTACGGGAGGCAGCAGTGGGGAATATTGCACAATGGGCGCAAGCCTGATGCAGCGACGCCGCGTGAGGGATG-AAGGCCTTCGGGTTGTAAACCTCTTTCGTCAGGGAACAAGGCAC-TGC------T-TT-G---GTGGTGTTGAGGGTAC-CT-G-GA-TAA---GAAGCGCCGGCTAACTACGTG
Actinobacteria_TAC-AACTGC-TTTT-GC--G	--------------GTAGCCGGCCTGAGAGGGTGGACGGTCACACTGGGACTGAGATACGGCCCAGACTCCTACGGGAGGCAGCAGTGGGGAATATTGCACAATGGGCGCAAGCCTGATGCAGCGACGCCGCGTGAGGGATG-AAGGCCTTCGGGTTGTAAACCTCTTTCGTCAGGGAACAAGGCAC-TGCT-----T-TTT---GGTGGTGTTGAGGGTAC-CT-G-GA-TAA---GAAGCGCCGGCTAACTACGTG
Actinobacteria_TAC-AACTGC-TTTTTGC--G	---------------TAGCCGGCCTGAGAGGGTGGACGGTCACACTGGGACTGAGATACGGCCCAGACTCCTACGGGAGGCAGCAGTGGGGAATATTGCACAATGGGCGCAAGCCTGATGCAGCGACGCCGCGTGAGGGATG-AAGGCCTTCGGGTTGTAAACCTCTTTCGTCAGGGAACAAGGCAC-TGCT-----T-TTTT--GGTGGTGTTGAGGGTAC-CT-G-GA-TAA---GAAGCGCCGGCTAACTACGTG
Actinobacteria_TAC-AACTGT--TTTTGC--G	--------------GTAGCCGGCCTGAGAGGGTGGACGGTCACACTGGGACTGAGATACGGCCCAGACTCCTACGGGAGGCAGCAGTGGGGAATATTGCACAATGGGCGCAAGCCTGATGCAGCGACGCCGCGTGAGGGATG-AAGGCCTTCGGGTTGTAAACCTCTTTCGTCAGGGAACAAGGCAC-TGTC-------TTTT--GGTGGTGTTGAGGGTAC-CT-G-GA-TAA---GAAGCGCCGGCTAACTACGTG
Actinobacteria_TAC-AACTGT-TTTTTGC--G	---------------TAGCCGGCCTGAGAGGGTGGACGGTCACACTGGGACTGAGATACGGCCCAGACTCCTACGGGAGGCAGCAGTGGGGAATATTGCACAATGGGCGCAAGCCTGATGCAGCGACGCCGCGTGAGGGATG-AAGGCCTTCGGGTTGTAAACCTCTTTCGTCAGGGAACAAGGCAC-TGTC-----T-TTTT--GGTGGTGTTGAGGGTAC-CT-G-GA-TAA---GAAGCGCCGGCTAACTACGTG
Actinobacteria_TAC-AATGCC-TTTTTGC--G	----------------AGCCGGCCTGAGAGGGTGGACGGTCACACTGGGACTGAGATACGGCCCAGACTCCTACGGGAGGCAGCAGTGGGGAATATTGCACAATGGGCGCAAGCCTGATGCAGCGACGCCGCGTGAGGGATG-AAGGCCTTCGGGTTGTAAACCTCTTTCGTCAGGGAACAAGGCATTGCCT-----T-TTTT--GGTGGTGTTGAGGGTAC-CT-G-GA-TAA---GAAGCGCCGGCTAACTACGTG
Actinobacteria_TAC-AATGTC---TTGGC--G	---------------TAGCCGGCCTGAGAGGGTGGACGGTCACACTGGGACTGAGACACGGCCCAGACTCCTACGGGAGGCAGCAGTGGGGAATATTGCACAATGGGCGCAAGCCTGATGCAGCGACGCCGCGTGAGGGATG-GAGGCCTTCGGGTTGTAAACCTCTTTCGCCAGTGAAGCAGGCCT-GTCCC-------TTG-TGGGTGGGTTGACGGTAG-CT-G-GA-TAA---GAAGCGCCGGCTAACTACGTG
Actinobacteria_TAC-AATGTC-TTTTGGC--G	-----------------GCCGGCCTGAGAGGGTGGACGGTCACACTGGGACTGAGACACGGCCCAGACTCCTACGGGAGGCAGCAGTGGGGAATATTGCACAATGGGCGCAAGCCTGATGCAGCGACGCCGCGTGAGGGATG-GAGGCCTTCGGGTTGTAAACCTCTTTCGCCAGTGAAGCAGGCCT-GTCCC----T-TTTG-TGGGTGGGTTGACGGTAG-CT-G-GA-TAA---GAAGCGCCGGCTAACTACGTG
Actinobacteria_TAC-AATTGC-TTTTTGC--G	---------------TAGCCGGCCTGAGAGGGTGGACGGTCACACTGGGACTGAGATACGGCCCAGACTCCTACGGGAGGCAGCAGTGGGGAATATTGCACAATGGGCGCAAGCCTGATGCAGCGACGCCGCGTGAGGGATG-AAGGCCTTCGGGTTGTAAACCTCTTTCGTCAGGGAACAAGGCAT-TGCC-----T-TTTT--GGTGGTGTTGAGGGTAC-CT-G-GA-TAA---GAAGCGCCGGCTAACTACGTG
Actinobacteria_TAC-AGCAAC-TCATGGT--G	-------------GGTAGCCGGCCTGAGAGGGTGACCGGTCACATTGGGACTGAGATACGGCCCAGACTCCTACGGGAGGCAGCAGTGGGGAATATTGCACAATGGGCGCAAGCCTGATGCAGCGACGCCGCGTGAGGGATG-GAGGCCTTCGGGTTGTGAACCTCTTTCGCTCATGGTCAAGCCGC-AAC------T-CATG---GTTGTGGTGAGGGTAG-TG-G-GT-AAA---GAAGCGCCGGCTAACTACGTG
Actinobacteria_TAC-AGCAAC-TCGTGGT--G	-------------GGTAGCCGGCCTGAGAGGGTGACCGGTCACATTGGGACTGAGATACGGCCCAGACTCCTACGGGAGGCAGCAGTGGGGAATATTGCACAATGGGCGCAAGCCTGATGCAGCGACGCCGCGTGAGGGATG-GAGGCCTTCGGGTTGTGAACCTCTTTCGCTCATGGTCAAGCCGC-AAC------T-CGTG---GTTGTGGTGAGGGTAG-TG-G-GT-AAA---GAAGCGCCGGCTAACTACGTG
Actinobacteria_TAC-AGCAAC-TGTGGGT--G	-------------GGTAGCCGGCCTGAGAGGGTGACCGGTCACATTGGGACTGAGATACGGCCCAGACTCCTACGGGAGGCAGCAGTGGGGAATATTGCACAATGGGCGCAAGCCTGATGCAGCGACGCCGCGTGAGGGATG-GAGGCCTTCGGGTTGTGAACCTCTTTCGCTCATGGTCAAGCCGC-AAC------T-GTGG---GTTGTGGTGAGGGTAG-TG-G-GT-AAA---GAAGCGCCGGCTAACTACGTG
Actinobacteria_TAC-AGCGCC-G-TTGGC--G	----------------AGCCGGCCTGAGAGGGTGGACGGTCACACTGGGACTGAGACACGGCCCAGACTCCTACGGGAGGCAGCAGTGGGGAATATTGCACAATGGGCGCAAGCCTGATGCAGCGACGCCGCGTGAGGGATG-GAGGCCTTCGGGTTGTGAACCTCTTTCGCCAGTGAAGCAGGCCC-GCCTC----G--TTG-TGGGTGGGTTGACGGTAG-CT-G-GA-TAA---GAAGCGCCGGCTAACTACGTG
Actinobacteria_TAC-AGCGCC-TTTTGGC--G	-----------------GCCGGCCTGAGAGGGTGGACGGTCACACTGGGACTGAGACACGGCCCAGACTCCTACGGGAGGCAGCAGTGGGGAATATTGCACAATGGGCGCAAGCCTGATGCAGCGACGCCGCGTGAGGGATG-GAGGCCTTCGGGTTGTGAACCTCTTTCGCCAGTGAAGCAGGCCC-GCCTC----T-TTTG-TGGGTGGGTTGACGGTAG-CT-G-GA-TAA---GAAGCGCCGGCTAACTACGTG
Actinobacteria_TAC-AGCTGCCTTTGTGCG-G	------------------CCGGCCTGAGAGGGTGGGCGGTCACACTGGGACTGAGACACGGCCCAGACTCCTACGGGAGGCAGCAGTGGGGAATATTGCACAATGGGCGCAAGCCTGATGCAGCGACGCCGCGTGAGGGATG-GAGGCCTTCGGGTTGTGAACCTCTTTCGCCAGTGAAGAAGGTCC-TGCT--C--T-TTGT--GGTGGGGTTGACGGTAG-CT-GGGTTAAT---GAAGCGCCGGCTAACTACGTG
Actinobacteria_TAC-AGTG-C-CTTGGGC--G	----------------AGCCGGCCTGAGAGGGTGGACGGTCACACTGGGACTGAGACACGGCCCAGACTCCTACGGGAGGCAGCAGTGGGGAATATTGCACAATGGGCGCAAGCCTGATGCAGCGACGCCGCGTGAGGGATG-GAGGCCTTCGGGTTGTGAACCTCTTTCGCCAGTGAAGCAGGCCT-G-CCC----C-TTGG-TGGGTGGGTTGACGGTAG-CT-G-GA-TAA---GAAGCGCCGGCTAACTACGTG
Actinobacteria_TAC-AGTGCC-GTTTGGC--G	-----------------GCCGGCCTGAGAGGGTGGACGGTCACACTGGGACTGAGACACGGCCCAGACTCCTACGGGAGGCAGCAGTGGGGAATATTGCACAATGGGCGCAAGCCTGATGCAGCGACGCCGCGTGAGGGATG-GAGGCCTTCGGGTTGTGAACCTCTTTCGCCAGTGAAGCAGGCCT-GCCTC----G-TTTG-TGGGTGGGTTGACGGTAG-CT-G-GA-TAA---GAAGCGCCGGCTAACTACGTG
Actinobacteria_TAC-AGTGCCCTG-GTGC--G	---------------TAGCCGGCCTGAGAGGGTGGACGGTCACACTGGGACTGAGACACGGCCCAGACTCCTACGGGAGGCAGCAGTGGGGAATATTGCACAATGGGCGCAAGCCTGATGCAGCGACGCCGCGTGAGGGATG-GAGGCCTTCGGGTTGTGAACCTCTTTCGCCAGTGAAGCAGGCCT-GCCC--C--T-G-GT--GGGTGGGTTGACGGTAG-CT-G-GA-TAA---GAAGCGCCGGCTAACTACGTG
Actinobacteria_TAC-AGTGCT-TTTTGGC--G	-------------------CGGCCTGAGAGGGTGGACGGTCACACTGGGACTGAGACACGGCCCAGACTCCTACGGGAGGCAGCAGTGGGGAATATTGCACAATGGGCGCAAGCCTGATGCAGCGACGCCGCGTGAGGGATG-GAGGCCTTCGGGTTGTGAACCTCTTTCGCCAGTGAAGCAGGCCT-GCTCC--TTT-TTTG-TGGGTGGGTTGACGGTAG-CT-G-GA-TAA---GAAGCGCCGGCTAACTACGTG
Actinobacteria_TAC-AGTGCTCT-TGTGC--G	---------------TAGCCGGCCTGAGAGGGTGGACGGTCACACTGGGACTGAGACACGGCCCAGACTCCTACGGGAGGCAGCAGTGGGGAATATTGCACAATGGGCGCAAGCCTGATGCAGCGACGCCGCGTGAGGGATG-GAGGCCTTCGGGTTGTGAACCTCTTTCGCCAGTGAAGCAGGCCT-GCTC--C--T--TGT--GGGTGGGTTGACGGTAG-CT-G-GA-TAA---GAAGCGCCGGCTAACTACGTG
Actinobacteria_TAC-AGTGCTCTGTGTGC--G	----------------AGCCGGCCTGAGAGGGTGGACGGTCACACTGGGACTGAGACACGGCCCAGACTCCTACGGGAGGCAGCAGTGGGGAATATTGCACAATGGGCGCAAGCCTGATGCAGCGACGCCGCGTGAGGGATG-GAGGCCTTCGGGTTGTGAACCTCTTTCGCCAGTGAAGCAGGCCT-GCTC--C--T-GTGT--GGGTGGGTTGACGGTAG-CT-G-GA-TAA---GAAGCGCCGGCTAACTACGTG
Actinobacteria_TAC-AGTGTC-T-GTGGC--G	----------------AGCCGGCCTGAGAGGGTGGACGGTCACACTGGGACTGAGACACGGCCCAGACTCCTACGGGAGGCAGCAGTGGGGAATATTGCACAATGGGCGCAAGCCTGATGCAGCGACGCCGCGTGAGGGATG-GAGGCCTTCGGGTTGTGAACCTCTTTCGCCAGTGAAGCAGGCCT-GTCCC----T--GTG-TGGGTGGGTTGACGGTAG-CT-G-GA-TAA---GAAGCGCCGGCTAACTACGTG
Actinobacteria_TAC-AGTGTC-TT--GGC--G	---------------TAGCCGGCCTGAGAGGGTGGACGGTCACACTGGGACTGAGACACGGCCCAGACTCCTACGGGAGGCAGCAGTGGGGAATATTGCACAATGGGCGCAAGCCTGATGCAGCGACGCCGCGTGAGGGATG-GAGGCCTTCGGGTTGTGAACCTCTTTCGCCAGTGAAGCAGGCCT-GTCCC----T-T--G-TGGGTGGGTTGACGGTAG-CT-G-GA-TAA---GAAGCGCCGGCTAACTACGTG
Actinobacteria_TAC-AGTGTC-TTTTGGC--G	-----------------GCCGGCCTGAGAGGGTGGACGGTCACACTGGGACTGAGACACGGCCCAGACTCCTACGGGAGGCAGCAGTGGGGAATATTGCACAATGGGCGCAAGCCTGATGCAGCGACGCCGCGTGAGGGATG-GAGGCCTTCGGGTTGTGAACCTCTTTCGCCAGTGAAGCAGGCCT-GTCCC----T-TTTG-TGGGTGGGTTGACGGTAG-CT-G-GA-TAA---GAAGCGCCGGCTAACTACGTG
Actinobacteria_TAC-CA------AAAG-G--G	CAAGGCGGTGACGGGTAGCCGGCCTGAGAGGGTGGACGGTCACACTGGGACTGAGACACGGCCCAGACTCCTACGGGAGGCAGCAGTGGGGAATATTGCACAATGGGCGCAAGCCTGATGCAGCGACGCCGCGTGAGGGATG-ACGGCCTTCGGGTTGTAAACCTCTGTTAGCATCGAAGAAGCG--------------AAAG----------TGACGGTAG-GT-G-CA-GAG---AAAGCGCCGGCTAACTACGTG
Actinobacteria_TAG-AACAAC-TGTGGGT--G	-------------GGTAGCCGGCCTGAGAGGGTGACCGGTCACATTGGGACTGAGATACGGCCCAGACTCCTACGGGAGGCAGCAGTGGGGAATATTGCACAATGGGCGGAAGCCTGATGCAGCGACGCCGCGTGAGGGATG-GAGGCCTTCGGGTTGTAAACCTCTTTCGCTCATGGTCAAGCCGC-AAC------T-GTGG---GTTGTGGTGAGGGTAG-TG-G-GT-AAA---GAAGCGCCGGCTAACTACGTG
Actinobacteria_TAG-AG-CTTTGTGT-GC-TG	------------------CCGGCCTGAGAGGGTGGGCGGTCACACTGGGACTGAGATACGGCCCAGACTCCTACGGGAGGCAGCAGTGGGGAATATTGCACAATGGGCGGAAGCCTGATGCAGCGACGTCGCGTGAGGGATG-GAGGCCTTCGGGTTGTGAACCTCTTTCGCCAGTGAGGAAGGC---CTTGCCT--G-TGT-GGTGGG--GTTGACGGTAG-CT-G-GG-TTAATTGAAGCGCCGGCTAACTACGTG
Actinobacteria_TAG-AGCCTTCGTGT-GC-TG	------------------CCGGCCTGAGAGGGTGGGCGGTCACACTGGGACTGAGATACGGCCCAGACTCCTACGGGAGGCAGCAGTGGGGAATATTGCACAATGGGCGGAAGCCTGATGCAGCGACGTCGCGTGAGGGATG-GAGGCCTTCGGGTTGTGAACCTCTTTCGCCAGTGAGGAAG--GC-CTTGCCC--G-TGT-GGTGGGGT--TGACGGTAG-CT-G-GG-TTAATTGAAGCGCCGGCTAACTACGTG
Actinobacteria_TGC-AGCTGC-TTGTGGC--G	----------------AGCCGGCCTGAGAGGGTGGACGGTCACACTGGGACTGAGACACGGCCCAGACTCCTGCGGGAGGCAGCAGTGGGGGATTTTGCACAATGGGCGCAAGCCTGATGCAGCGACGCCGCGTGAGGGATG-GAGGCCTTCGGGTTGTGAACCTCTGTCGCCGGTGATGTAGGCTC-TGCT-----T-TGTG--GGTGGGGTTGACGGTAG-CC-G-GGGTAT---GAAGTGCCGGCTAACTACGTG
Bacteroidetes_CAACC-ATGCTCTTAGTATATC	--------------------AGAGGGTGATCCCCCACACTGGGACTGAGACACGGCCCAGACTCCTACGGGAGGCAGCAGTGAGGAATATTGGACAATGGGTGAAAGCCTGATCCAGCCATCCCGCGTGCAGGA-CGACTGCCC-TA-TGGG-TTGTAAACTGCTTTTATATAGGGA-T--AAACCTA-CTCT-CGTGAGAGTAG-CTGAAGGTACTAT-ATGAATAAGCACCGGCTAACTCCGTG
Bacteroidetes_CAATA-AAG--------TTTGA	-TATGACGGAAACTGGTCTGAGAGGATGATCAGTCACAATGGAACTGAGACACGGTCCATACTCCTACGGGAGGCAGCAGTGAGGAATCTTCCACAATGGACGAAAGTCTGATGGAGCGACACCGCGTGAAGGA-AGAAGG-CC-TA-ACGG-TTGTAAACTTCTTTTCTGAAGGAG-C--A---------------------TA-ATGAGAGTACTTT-AGGAATAAGGGACGGCTAAATACGTG
Bacteroidetes_CAATA-TCA-------GACTAC	--ACGATCAGAGCCGGACTGAGAGGTTGAACGGCCACATTGGGACTGAGATACGGCCCAGACTCCTACGGGAGGCAGCAGTCGGGAATATTGCGCAATGGAGGAAACTCTGACGCAGTGACGCCGCGTGCAGGA-AGAAGG-TT-TT-CGGA-TTGTAAACTGCTTTAGACAGGGAA-G--A--------------------GAA-AGGACAGTACCTG-TAGAATAAGCTCCGGCTAACTACGTG
Bacteroidetes_CAATA-TCA------AAACTTC	----GATCAGAGCCGGACTGAGAGGTTGAACGGCCACATTGGGACTGAGATACGGCCCAGACTCCTACGGGAGGCAGCAGTCGGGAATATTGCGCAATGGAGGAAACTCTGACGCAGTGACGCCGCGTGCAGGA-AGAAGG-TT-TT-CGGA-TTGTAAACTGCTTTTAACAGGAAA-G--AA------------------AAAA-ATGACGGTACCTG-TTGAATAAGCTCCGGCTAACTACGTG
Bacteroidetes_CAATT-ATAACGATGTAGCTCC	--------------------------TGATCGGCCACACTGGGACTGAGACACGGCCCAGACTCCTACGGGAGACAGCAGTTAGGAATATTTGTCAATGGAGGAAACTCTGAACAAGCAATGCCGCGTGAAGGA-TGACGGTCC-TA-TGGA-TTGTAAACTTCTGTTGTTAGGGAAGACACTACACAGGAAA-TGTGT-GTAGA-GTGACGGTACCTT-TCAAGAAAGCTCCGGCTAACTACGTG
Bacteroidetes_CAATT-ATGTTGGACTTACATT	--------------------AGAGGAAGGTCCCCCACATTGGAACTGAGACACGGTCCAAACTCCTACGGGAGGCAGCAGTGAGGAATATTGGTCAATGGATGAAAATCTGAACCAGCCAAGTAGCGTGCAGGA-TGACGGCCC-TA-TGGG-TTGTAAACTGCTTTTATGTGAGAA-T--AAAGTTA-GGTATGTA-TACTTAT-TTGCATGTATCAC-ATGAATAAGGACCGGCTAATTCCGTG
Bacteroidetes_CAATT-CTGAAAGTCTCTCTAT	--------------------AGAGGAAGGTCCCCCACACTGGAACTGAGACACGGTCCAGACTCCTACGGGAGGCAGCAGTGAGGAATATTGGTCAATGGACGAAAGTCTGAACCAGCCAAGTAGCGTGCAGGA-TGACGGCCC-TC-TGGG-TTGTAAACTGCTTTTAGTTGGGAA-T--AAAAAAG-AGGA-CGTGTCCTCTA-TTGTATGTACCTT-CAGAAAAAGGACCGGCTAATTCCGTG
Bacteroidetes_CAGAACATGTGGACTTTTTGCC	--------------------AGAGGAAGGTCCCCCACACTGGTACTGAGACACGGACCAGACTCCTACGGGAGGCAGCAGTGAGGAATATTGGTCAATGGTCGAGAGACTGAACCAGCCAAGTCGCGTGAAGGA-AGACGG-CTCTA-TGAG-TTGTAAACTTCTTTTGTACAGGAG-T--AAAGTGA-GACA-CGCGTGTTTTA-TTGCAAGTACTGT-ACGAATAAGCATCGGCTAACTCCGTG
Bacteroidetes_CAGAACATGTGGATTTTTTGCC	--------------------AGAGGAAGGTCCCCCACACTGGTACTGAGACACGGACCAGACTCCTACGGGAGGCAGCAGTGAGGAATATTGGTCAATGGTCGAGAGACTGAACCAGCCAAGTCGCGTGAAGGA-AGACGG-CTCTA-TGAG-TTGTAAACTTCTTTTGTACAGGAG-T--AAAGTGA-GACA-CGTGTGTTTTA-TTGCAAGTACTGT-ACGAATAAGCATCGGCTAACTCCGTG
Bacteroidetes_CAGCA-ATGTCATTATTGCACT	--------------------AGAGGAAGGTCCCCCACATTGGAACTGAGACACGGTCCAAACTCCTACGGGAGGCAGCAGTGAGGAATATTGGTCAATGGGCGAGAGCCTGAACCAGCCAAGTAGCGTGCAGGA-AGACGGCCC-TA-TGGG-TTGTAAACTGCTTTTGTATGGGGA-T--AAAGTCA-ATCA-CGTGTGATTGT-TTGCAGGTACCAT-ACGAATAAGGACCGGCTAATTCCGTG
Bacteroidetes_CAGCA-ATGTGGCTGTTTCATT	--------------------AGAGGAAGGTCCCCCACATTGGAACTGAGACACGGTCCAAACTCCTACGGGAGGCAGCAGTGAGGAATATTGGTCAATGGGCGAGAGCCTGAACCAGCCAAGTAGCGTGCAGGA-AGACGGCCC-TA-TGGG-TTGTAAACTGCTTTTATGTGGGGA-T--AAAGTGA-GCTA-CGTGTAGTTTA-TTGCAGGTACCAC-ATGAATAAGGACCGGCTAATTCCGTG
Bacteroidetes_CAGCA-ATGTGGTTACTTCTTT	--------------------AGAGGAAGGTCCCCCACATTGGAACTGAGACACGGTCCAAACTCCTACGGGAGGCAGCAGTGAGGAATATTGGTCAATGGGCGAGAGCCTGAACCAGCCAAGTAGCGTGCAGGA-AGACGGCCC-TA-TGGG-TTGTAAACTGCTTTTATAAGGGAA-T--AAAGTGG-GTCA-CGTGTGACTTT-TTGCATGTACCTT-ATGAATAAGGACCGGCTAATTCCGTG
Bacteroidetes_CAGCACAAAGGGAATTGCCGAC	--------------------AGAGGTTTATCCCCCACACTGGTACTGAGACACGGACCAGACTCCTACGGGAGGCAGCAGTGAGGAATATTGGTCAATGGGCGAGAGCCTGAACCAGCCAAGTCGCGTGAAGGA-AGACAG-TCCTA-AGGA-TTGTAAACTTCTTTTATACGGGAA-T--AACGGGC-GATA-CGAGTATTGCA-TTGAATGTACCGT-AAGAATAAGCATCGGCTAACTCCGTG
Bacteroidetes_CAGCACATGTGGGTCCTCCGTT	--------------------AGAGGAAGGTCCCCCACATTGGAACTGAGACACGGTCCAAACTCCTACGGGAGGCAGCAGTGAGGAATATTGGTCAATGGGCGAGAGCCTGAACCAGCCAAGTAGCGTGCAGGA-AGACGG-CCCTA-TGGG-TTGTAAACTGCTTTTATGCGGGGA-T--AAAGTGA-GGGA-CGTGTCCCTCA-TTGCAGGTACCGC-ATGAATAAGGACCGGCTAATTCCGTG
Bacteroidetes_CAGCACATGTGGGTCTTCCGTT	--------------------AGAGGAAGGTCCCCCACATTGGAACTGAGACACGGTCCAAACTCCTACGGGAGGCAGCAGTGAGGAATATTGGTCAATGGGCGAGAGCCTGAACCAGCCAAGTAGCGTGCAGGA-AGACGG-CCCTA-TGGG-TTGTAAACTGCTTTTATGCGGGGA-T--AAAGTGA-GGGA-CGTGTCCTTCA-TTGCAGGTACCGC-ATGAATAAGGACCGGCTAATTCCGTG
Bacteroidetes_CAGCACATGTGTCTGTTTCCTT	--------------------AGAGGAAGGTCCCCCACATTGGAACTGAGACACGGTCCAAACTCCTACGGGAGGCAGCAGTGAGGAATATTGGTCAATGGGCGAGAGCCTGAACCAGCCAAGTAGCGTGCAGGA-AGACGG-CCCTA-TGGG-TTGTAAACTGCTTTTATAGGGGAA-T--AAAGTGA-TCTA-CGTGTAGTTTA-TTGTATGTACCCT-ATGAATAAGGACCGGCTAATTCCGTG
Bacteroidetes_CAGCC-ATGTCATTATTGCACT	--------------------AGAGGAAGGTCCCCCACATTGGAACTGAGACACGGTCCAAACTCCTACGGGAGGCAGCAGTGAGGAATATTGGTCAATGGGCGAGAGCCTGAACCAGCCAAGTAGCGTGCAGGA-CGACGGCCC-TA-TGGG-TTGTAAACTGCTTTTGTATGGGGA-T--AAAGTCA-ATCA-CGTGTGATTGT-TTGCAGGTACCAT-ACGAATAAGGACCGGCTAATTCCGTG
Bacteroidetes_CAGCCCATAGCGCTGCTGTCCC	---------------------GAGGTTGACCCCCCACACTGGTACTGAGACACGGACCAGACTCCTACGGGAGGCAGCAGTGAGGAATATTGGTCAATGGGCGAGAGCCTGAACCAGCCAAGTCGCGTGAAGGA-CGACGG-TTCTA-TGGA-TTGTAAACTTCTTTTGTAGAGGAA-T--AATGGCA-GCTA-CGTGTAGCTGAGATGCATGTACTCT-ACGAATAAGTATCGGCTAACTCCGTG
Bacteroidetes_CAGCT-ATGTGGCTGTTTCCTT	--------------------AGAGGAAGGTCCCCCACATTGGAACTGAGACACGGTCCAAACTCCTACGGGAGGCAGCAGTGAGGAATATTGGTCAATGGGCGAGAGCCTGAACCAGCCAAGTAGCGTGCAGGA-TGACGGCCC-TA-TGGG-TTGTAAACTGCTTTTATAGGGGAA-T--AAAGTGA-GCTA-CGTGTAGTTTA-TTGCATGTACCCT-ATGAATAAGGACCGGCTAATTCCGTG
Bacteroidetes_CAGCT-TAGAAGGTCCATCCCC	--------------------AGAGGTTGAACCCCCACACTGGTACTGAGACACGGACCAGACTCCTACGGGAGGCAGCAGTGAGGAATATTGGTCAATGGGCGAGAGCCTGAACCAGCCAAGTCGCGTGAAGGA-TGACTG-TC-TT-ATGGATTGTAAACTTCTTTTGTAGGGGAA-T--AAAGAAT-GGTA-CGTGTACCATA-GTGAATGTACCCT-ACGAATAAGCATCGGCTAACTCCGTG
Bacteroidetes_CAGCT-TAGAAGGTCCGTCCCC	--------------------AGAGGTTGAACCCCCACACTGGTACTGAGACACGGACCAGACTCCTACGGGAGGCAGCAGTGAGGAATATTGGTCAATGGGCGAGAGCCTGAACCAGCCAAGTCGCGTGAAGGA-TGACTG-TC-TT-ATGGATTGTAAACTTCTTTTGTAGGGGAA-T--AAAGAAC-GGTA-CGTGTACCGTA-GTGAATGTACCCT-ACGAATAAGCATCGGCTAACTCCGTG
Bacteroidetes_CAGCT-TAGAGGGTCCTCCCCC	--------------------AGAGGTTGAACCCCCACACTGGTACTGAGACACGGACCAGACTCCTACGGGAGGCAGCAGTGAGGAATATTGGTCAATGGGCGAGAGCCTGAACCAGCCAAGTCGCGTGAAGGA-TGACTG-TC-TT-ATGGATTGTAAACTTCTTTTGTAGGGGAA-T--AAAGAGG-GGCA-CGTGTGCCTCA-GTGAATGTACCCT-ACGAATAAGCATCGGCTAACTCCGTG
Bacteroidetes_CAGCT-TTAAGGCAGCTCCGTC	--------------------AGAGGTTGAACCCCCACACTGGTACTGAGACACGGACCAGACTCCTACGGGAGGCAGCAGTGAGGAATATTGGTCAATGGGCGAGAGCCTGAACCAGCCAAGTCGCGTGAAGGA-TGACTG-TC-TTATGGA-TTGTAAACTTCTTTTATACGGGAA-T--AACAAGA-GCCA-CGAGTGGCTCC-CTGCATGTACCGT-ATGAATAAGCATCGGCTAACTCCGTG
Bacteroidetes_CAGCT-TTAAGGCTACTCCGTC	--------------------AGAGGTTGAACCCCCACACTGGTACTGAGACACGGACCAGACTCCTACGGGAGGCAGCAGTGAGGAATATTGGTCAATGGGCGAGAGCCTGAACCAGCCAAGTCGCGTGAAGGA-TGACTG-TC-TTATGGA-TTGTAAACTTCTTTTATACGGGAA-T--AACAAGA-GCCA-CGTGTGACTCC-CTGCATGTACCGT-ATGAATAAGCATCGGCTAACTCCGTG
Bacteroidetes_CAGCT-TTAAGGCTGCTCCGTC	--------------------AGAGGTTGAACCCCCACACTGGTACTGAGACACGGACCAGACTCCTACGGGAGGCAGCAGTGAGGAATATTGGTCAATGGGCGAGAGCCTGAACCAGCCAAGTCGCGTGAAGGA-TGACTG-TC-TTATGGA-TTGTAAACTTCTTTTATACGGGAA-T--AACAAGA-GCCA-CGTGTGGCTCC-CTGCATGTACCGT-ATGAATAAGCATCGGCTAACTCCGTG
Bacteroidetes_CAGCT-TTAAGGTAACTCCGTC	--------------------AGAGGTTGAACCCCCACACTGGTACTGAGACACGGACCAGACTCCTACGGGAGGCAGCAGTGAGGAATATTGGTCAATGGGCGAGAGCCTGAACCAGCCAAGTCGCGTGAAGGA-TGACTG-TC-TTATGGA-TTGTAAACTTCTTTTATACGGGAA-T--AACAAGA-GTCA-CGAGTGACTCC-CTGCATGTACCGT-ATGAATAAGCATCGGCTAACTCCGTG
Bacteroidetes_CAGCT-TTAAGGTTACTCCGTC	--------------------AGAGGTTGAACCCCCACACTGGTACTGAGACACGGACCAGACTCCTACGGGAGGCAGCAGTGAGGAATATTGGTCAATGGGCGAGAGCCTGAACCAGCCAAGTCGCGTGAAGGA-TGACTG-TC-TTATGGA-TTGTAAACTTCTTTTATACGGGAA-T--AACAAGA-GTCA-CGTGTGACTCC-CTGCATGTACCGT-ATGAATAAGCATCGGCTAACTCCGTG
Bacteroidetes_CAGCT-TTAAGGTTGCTCCGTC	--------------------AGAGGTTGAACCCCCACACTGGTACTGAGACACGGACCAGACTCCTACGGGAGGCAGCAGTGAGGAATATTGGTCAATGGGCGAGAGCCTGAACCAGCCAAGTCGCGTGAAGGA-TGACTG-TC-TTATGGA-TTGTAAACTTCTTTTATACGGGAA-T--AACAAGA-GTCA-CGTGTGGCTCC-CTGCATGTACCGT-ATGAATAAGCATCGGCTAACTCCGTG
Bacteroidetes_CAGCTCACATACCTGGATCGTC	--------------------AGAGGAAGGTCCCCCACATTGGAACTGAGACACGGTCCAAACTCCTACGGGAGGCAGCAGTGAGGAATATTGGTCAATGGGCGAGAGCCTGAACCAGCCAAGTAGCGTGAAGGA-TGAAGG-TCCTA-CGGA-TTGTAAACTTCTTTTATACGGGAA-T--AAAGTAT-CCTA-CGTGTAGGATT-TTGTATGTACCGT-ATGAATAAGCATCGGCTAACTCCGTG
Bacteroidetes_CAGCTCACATTCCTGGATCGTC	--------------------AGAGGAAGGTCCCCCACATTGGAACTGAGACACGGTCCAAACTCCTACGGGAGGCAGCAGTGAGGAATATTGGTCAATGGGCGAGAGCCTGAACCAGCCAAGTAGCGTGAAGGA-TGAAGG-TCCTA-CGGA-TTGTAAACTTCTTTTATACGGGAA-T--AAAGTTT-CCTA-CGTGTAGGATT-TTGTATGTACCGT-ATGAATAAGCATCGGCTAACTCCGTG
Bacteroidetes_CAGCTCACGGACCTGGCTCGCC	---------------------GAGGAAGGTCCCCCACATTGGAACTGAGACACGGTCCAAACTCCTACGGGAGGCAGCAGTGAGGAATATTGGTCAATGGGCGAGAGCCTGAACCAGCCAAGTAGCGTGAAGGA-TGACGG-CCCTA-CGGG-TTGTAAACTTCTTTTGTGCGGGAA-T--AAAGGAG-CCTA-CGTGTAGGCTT-TTGCATGTACCGTAACGAATAAGCATCGGCTAACTCCGTG
Bacteroidetes_CAGCTCATGATTTTGATACCCC	--------------------AGAGGAAAGTCCCCCACACTGGTACTGAGACACGGACCAGACTCCTACGGGAGGCAGCAGTGAGGAATATTGGTCAATGGGCGAGAGCCTGAACCAGCCAAGTCGCGTGAAGGA-TGACGG-CCCTA-TGGG-TTGTAAACTTCTTTTGCAGGGGAA-T--AAAGATA-TTCA-CGTGTGGATAG-TTGTATGTACCCT-GCGAATAAGCATCGGCTAACTCCGTG
Bacteroidetes_CAGCTCATGATTTTGGTACCCC	--------------------AGAGGAAAGTCCCCCACACTGGTACTGAGACACGGACCAGACTCCTACGGGAGGCAGCAGTGAGGAATATTGGTCAATGGGCGAGAGCCTGAACCAGCCAAGTCGCGTGAAGGA-TGACGG-CCCTA-TGGG-TTGTAAACTTCTTTTGCAGGGGAA-T--AAAGATA-TTCA-CGTGTGGGTAG-TTGTATGTACCCT-GCGAATAAGCATCGGCTAACTCCGTG
Bacteroidetes_CAGCTCATGTATCTGAATCATC	--------------------AGAGGAAGGTCCCCCACATTGGAACTGAGACACGGTCCAAACTCCTACGGGAGGCAGCAGTGAGGAATATTGGTCAATGGGCGAGAGCCTGAACCAGCCAAGTAGCGTGAAGGA-TGAAGG-CTCTA-TGGG-TCGTAAACTTCTTTTATATGGGAA-T--AAAGTAT-TCCA-CGTGTGGAATT-TTGTATGTACCAT-ATGAATAAGGATCGGCTAACTCCGTG
Bacteroidetes_CAGCTCATGTCATTATTGCACT	--------------------AGAGGAAGGTCCCCCACATTGGAACTGAGACACGGTCCAAACTCCTACGGGAGGCAGCAGTGAGGAATATTGGTCAATGGGCGAGAGCCTGAACCAGCCAAGTAGCGTGCAGGA-TGACGG-CCCTA-TGGG-TTGTAAACTGCTTTTGTATGGGGA-T--AAAGTCA-ATCA-CGTGTGATTGT-TTGCAGGTACCAT-ACGAATAAGGACCGGCTAATTCCGTG
Bacteroidetes_CAGCTCATGTCGGACCCGTTTC	--------------------AGAGGAAGGTCCCCCACATTGGAACTGAGACACGGTCCAAACTCCTACGGGAGGCAGCAGTGAGGAATATTGGTCAATGGGCGAGAGCCTGAACCAGCCAAGTAGCGTGAAGGA-TGACTG-CCCTA-TGGG-TTGTAAACTTCTTTTATAAAGGAA-T--AAAGTCG-GGTATGGA-TACCCGT-TTGCATGTACTTT-ATGAATAAGGATCGGCTAACTCCGTG
Bacteroidetes_CAGCTCATGTCGTTATTGCACT	--------------------AGAGGAAGGTCCCCCACATTGGAACTGAGACACGGTCCAAACTCCTACGGGAGGCAGCAGTGAGGAATATTGGTCAATGGGCGAGAGCCTGAACCAGCCAAGTAGCGTGCAGGA-TGACGG-CCCTA-TGGG-TTGTAAACTGCTTTTGTATGGGGA-T--AAAGTCA-GTCA-CGTGTGATTGT-TTGCAGGTACCAT-ACGAATAAGGACCGGCTAATTCCGTG
Bacteroidetes_CAGCTCATGTGGCTGTTTCATT	--------------------AGAGGAAGGTCCCCCACATTGGAACTGAGACACGGTCCAAACTCCTACGGGAGGCAGCAGTGAGGAATATTGGTCAATGGGCGAGAGCCTGAACCAGCCAAGTAGCGTGCAGGA-TGACGG-CCCTA-TGGG-TTGTAAACTGCTTTTATGTGGGGA-T--AAAGTGA-GCTA-CGTGTAGTTTA-TTGCAGGTACCAC-ATGAATAAGGACCGGCTAATTCCGTG
Bacteroidetes_CAGCTCATGTGGGTCTTCCGTT	--------------------AGAGGAAGGTCCCCCACATTGGAACTGAGACACGGTCCAAACTCCTACGGGAGGCAGCAGTGAGGAATATTGGTCAATGGGCGAGAGCCTGAACCAGCCAAGTAGCGTGCAGGA-TGACGG-CCCTA-TGGG-TTGTAAACTGCTTTTATGCGGGGA-T--AAAGTGA-GGGA-CGTGTCCTTCA-TTGCAGGTACCGC-ATGAATAAGGACCGGCTAATTCCGTG
Bacteroidetes_CAGCTCATGTGGTTACTTCTTT	--------------------AGAGGAAGGTCCCCCACATTGGAACTGAGACACGGTCCAAACTCCTACGGGAGGCAGCAGTGAGGAATATTGGTCAATGGGCGAGAGCCTGAACCAGCCAAGTAGCGTGCAGGA-TGACGG-CCCTA-TGGG-TTGTAAACTGCTTTTATAAGGGAA-T--AAAGTGA-GTCT-CGTGAGACTTT-TTGCATGTACCTT-ATGAATAAGGACCGGCTAATTCCGTG
Bacteroidetes_CAGCTCATGTTTCTGAATCATC	--------------------AGAGGAAGGTCCCCCACATTGGAACTGAGACACGGTCCAAACTCCTACGGGAGGCAGCAGTGAGGAATATTGGTCAATGGGCGAGAGCCTGAACCAGCCAAGTAGCGTGAAGGA-TGAAGG-CTCTA-TGGG-TCGTAAACTTCTTTTATATGGGAA-T--AAAGTTT-TCCA-CGTGTGGAATT-TTGTATGTACCAT-ATGAATAAGGATCGGCTAACTCCGTG
Bacteroidetes_CAGCTCCCGAAGGTCCTTCTAT	--------------------AGAGGAAGGTCCCCCACACTGGAACTGAGACACGGTCCAGACTCCTACGGGAGGCAGCAGTGAGGAATATTGGTCAATGGGCGAGAGCCTGAACCAGCCAAGTAGCGTGCAGGA-TGACGG-CCCTC-CGGG-TTGTAAACTGCTTTTAGTTGGGAA-T--AAAAAAA-GGGA-CTTGTCCCTTC-TTGTATGTACCTT-CAGAAAAAGGACCGGCTAATTCCGTG
Bacteroidetes_CAGCTCCTGAAGCTGCCTCAAT	--------------------AGAGGAAGGTCCCCCACATTGGAACTGAGACACGGTCCAAACTCCTACGGGAGGCAGCAGTGAGGAATATTGGTCAATGGGCGAGAGCCTGAACCAGCCAAGTAGCGTGCAGGA-TGACGG-CCCTC-TGGG-TTGTAAACTGCTTTTAGTTGGGAA-C--ATAAAAG-GCGA-CGTGTCGCCTC-TGGAGTGTACCAT-CAGAAAAAGGACCGGCTAATTCCGTG
Bacteroidetes_CAGCTCTGGTGACTGTGTCTAT	---------------------GAGGAAGGTCCCCCACATTGGAACTGAGATACGGTCCAAACTCCTACGGGAGGCAGCAGTGAGGAATATTGGTCAATGGGCGAGAGCCTGAACCAGCCAAGTAGCGTGCGGGA-TGAAGG-CCCTT-GTGG-TCGTAAACCGCTTTTATCAGTGAA-T--AAAGTGC-ACCA-CGTGTGGTGTCATTGCAGGTAGCTG-AAGAAAAAGGACCGGCTAATTCCGTG
Bacteroidetes_CAGCTCTGGTGATTGTGTCTAT	---------------------GAGGAAGGTCCCCCACATTGGAACTGAGATACGGTCCAAACTCCTACGGGAGGCAGCAGTGAGGAATATTGGTCAATGGGCGAGAGCCTGAACCAGCCAAGTAGCGTGCGGGA-TGAAGG-CCCTT-GTGG-TCGTAAACCGCTTTTATCAGTGAA-T--AAAGTGC-ATCA-CGTGTGGTGTCATTGCAGGTAGCTG-AAGAAAAAGGACCGGCTAATTCCGTG
Bacteroidetes_CAGCTTATAAAAGTCTGTCCCC	--------------------AGAGGTTGAACCCCCACACTGGTACTGAGACACGGACCAGACTCCTACGGGAGGCAGCAGTGAGGAATATTGGTCAATGGGCGAGAGCCTGAACCAGCCAAGTCGCGTGAAGGA-TGACTG-TCTTA-TGGA-TTGTAAACTTCTTTTGTAGGGGAA-T--AAAGAAC-AGCA-CGTGTGCTGTA-GTGAATGTACCCT-ACGAATAAGCATCGGCTAACTCCGTG
Bacteroidetes_CAGCTTATAAGGTTACCCCGTC	--------------------AGAGGTTTATCCCCCACACTGGTACTGAGACACGGACCAGACTCCTACGGGAGGCAGCAGTGAGGAATATTGGTCAATGGGCGAGAGCCTGAACCAGCCAAGTCGCGTGAAGGA-TGACTG-TCTTA-TGGA-TTGTAAACTTCTTTTATACGGGAA-T--AACAAGG-GTCA-CGTGTGACCCC-CTGCATGTACCGT-ATGAATAAGCATCGGCTAACTCCGTG
Bacteroidetes_CAGCTTATAAGGTTACTCCGTC	--------------------AGAGGTTTATCCCCCACACTGGTACTGAGACACGGACCAGACTCCTACGGGAGGCAGCAGTGAGGAATATTGGTCAATGGGCGAGAGCCTGAACCAGCCAAGTCGCGTGAAGGA-TGACTG-TCTTA-TGGA-TTGTAAACTTCTTTTATACGGGAA-T--AACAAGA-GTCA-CGTGTGACTCC-CTGCATGTACCGT-ATGAATAAGCATCGGCTAACTCCGTG
Bacteroidetes_CAGGACATTTGAGTCTTTCCTC	--------------------AGAGGAAGGTCCCCCACATTGGTACTGAGACACGGACCAAACTCCTACGGGAGGCAGCAGTGAGGAATATTGGTCAATGGCCGAGAGGCTGAACCAGCCAAGTCGCGTGAAGGA-AGAAGG-ATCTA-TGGT-TTGTAAACTTCTTTTATAGGGGAA-T--AAAGTGG-AGGA-CGTGTCCTTTT-TTGTATGTACCCT-ATGAATAAGCATCGGCTAACTCCGTG
Bacteroidetes_CAGGTCATATGGGTCCGTCTTC	--------------------AGAGGAAGGTCCCCCACATTGGTACTGAGACACGGACCAAACTCCTACGGGAGGCAGCAGTGAGGAATATTGGTCAATGGCCGAGAGGCTGAACCAGCCAAGTCGCGTGAGGGA-TGAAGG-TTCTA-TGGA-TCGTAAACCTCTTTTATAAGGGAA-T--AAAGTGC-GGGA-CGTGTCCCGTT-TTGTATGTACCTT-ATGAATAAGGATCGGCTAACTCCGTG
Bacteroidetes_CAGTA-ATGAGTCTGAATCTTC	--------------------AGAGGAAGGTCCCCCACATTGGAACTGAGACACGGTCCAAACTCCTACGGGAGGCAGCAGTGAGGAATATTGGTCAATGGACGAGAGTCTGAACCAGCCAAGTCGCGTGAGGGA-AGACTGCCC-TA-TGGG-TTGTAAACCTCTTTTATAAGGGAA-G--AATAAGT-TCTA-CGTGTAGAATG-ATGCCTGTACCTT-ATGAATAAGCATCGGCTAACTCCGTG
Bacteroidetes_CAGTACATGTGGATTCTTCTTT	--------------------AGAGGAAGGTCCCCCACATTGGAACTGAGACACGGTCCAAACTCCTACGGGAGGCAGCAGTGAGGAATATTGGTCAATGGACGAGAGTCTGAACCAGCCAAGTAGCGTGCAGGA-AGACGG-CCCTA-TGGG-TTGTAAACTGCTTTTATAAGGGAA-T--AAAGTGA-GAGT-CGTGACTCTTT-TTGCATGTACCTT-ATGAATAAGGACCGGCTAATTCCGTG
Bacteroidetes_CAGTACATGTGGTTACTTCTTT	--------------------AGAGGAAGGTCCCCCACATTGGAACTGAGACACGGTCCAAACTCCTACGGGAGGCAGCAGTGAGGAATATTGGTCAATGGACGAGAGTCTGAACCAGCCAAGTAGCGTGCAGGA-AGACGG-CCCTA-TGGG-TTGTAAACTGCTTTTATAAGGGAA-T--AAAGTGA-GTCT-CGTGAGACTTT-TTGCATGTACCTT-ATGAATAAGGACCGGCTAATTCCGTG
Bacteroidetes_CAGTACATGTTGTTACTTCTTT	--------------------AGAGGAAGGTCCCCCACATTGGAACTGAGACACGGTCCAAACTCCTACGGGAGGCAGCAGTGAGGAATATTGGTCAATGGACGAGAGTCTGAACCAGCCAAGTAGCGTGCAGGA-AGACGG-CCCTA-TGGG-TTGTAAACTGCTTTTATAAGGGAA-T--AAAGTTA-GTCT-CGTGAGACTTT-TTGCATGTACCTT-ATGAATAAGGACCGGCTAATTCCGTG
Bacteroidetes_CAGTACATTGCGCTGCCGCGAC	-------------------GAGAGGAAGGTCCCCCACATTGGTACTGAGACACGGACCAAACTCCTACGGGAGGCAGCAGTGAGGAATATTGGTCAATGGACGAGAGTCTGAACCAGCCAAGTCGCGTGAAGGA-AGACGG-ATCTA-TGGT-TTGTAAACTTCTTTAGTGCGGGAA-C--AA-AGCG-GCGT-CGTGACGCCGG-ATGAGTGTACCGC-AAGAATAAGCATCGGCTAACTCCGTG
Bacteroidetes_CAGTT-ATGTCATTATTGCACT	--------------------AGAGGAAGGTCCCCCACATTGGAACTGAGACACGGTCCAAACTCCTACGGGAGGCAGCAGTGAGGAATATTGGTCAATGGACGAGAGTCTGAACCAGCCAAGTAGCGTGCAGGA-TGACGGCCC-TA-TGGG-TTGTAAACTGCTTTTGTATGGGGA-T--AAAGTCA-ATCA-CGTGTGATTGT-TTGCAGGTACCAT-ACGAATAAGGACCGGCTAATTCCGTG
Bacteroidetes_CAGTT-ATGTGGTTACTTCTTT	--------------------AGAGGAAGGTCCCCCACATTGGAACTGAGACACGGTCCAAACTCCTACGGGAGGCAGCAGTGAGGAATATTGGTCAATGGACGAGAGTCTGAACCAGCCAAGTAGCGTGCAGGA-TGACGGCCC-TA-TGGG-TTGTAAACTGCTTTTATAAGGGAA-T--AAAGTGA-GTCT-CGTGAGACTTT-TTGCATGTACCTT-ATGAATAAGGACCGGCTAATTCCGTG
Bacteroidetes_CAGTTCACACCCCTGGAGCTTC	--------------------AGAGGAAGGTCCCCCACATTGGAACTGAGACACGGTCCAAACTCCTACGGGAGGCAGCAGTGAGGAATATTGGTCAATGGACGAGAGTCTGAACCAGCCAAGTAGCGTGAAGGA-TGAAGG-TCCTA-CGGA-TTGTAAACTTCTTTTATAAGGGAA-T--AAACCCT-CCCA-CGTGTGGGAGC-TTGTATGTACCTT-ATGAATAAGCATCGGCTAACTCCGTG
Bacteroidetes_CAGTTCATAGATCCGATTCGTC	--------------------AGAGGAAGGTCCCCCACATTGGAACTGAGACACGGTCCAAACTCCTACGGGAGGCAGCAGTGAGGAATATTGGTCAATGGACGAGAGTCTGAACCAGCCAAGTAGCGTGAAGGA-TGAAGG-TTCTA-TGGA-TTGTAAACTTCTTTTATACGGGAA-T--AAACGAA-TCCA-CGCGTGGATTT-TTGCATGTACCGT-ATGAATAAGGATCGGCTAACTCCGTG
Bacteroidetes_CAGTTCATAGATCTGATTCGTC	--------------------AGAGGAAGGTCCCCCACATTGGAACTGAGACACGGTCCAAACTCCTACGGGAGGCAGCAGTGAGGAATATTGGTCAATGGACGAGAGTCTGAACCAGCCAAGTAGCGTGAAGGA-TGAAGG-TTCTA-TGGA-TTGTAAACTTCTTTTATACGGGAA-T--AAACGAA-TCCA-CGTGTGGATTT-TTGCATGTACCGT-ATGAATAAGGATCGGCTAACTCCGTG
Bacteroidetes_CAGTTCATAGGTCCGATTCGTC	--------------------AGAGGAAGGTCCCCCACATTGGAACTGAGACACGGTCCAAACTCCTACGGGAGGCAGCAGTGAGGAATATTGGTCAATGGACGAGAGTCTGAACCAGCCAAGTAGCGTGAAGGA-TGAAGG-TTCTA-TGGA-TTGTAAACTTCTTTTATACGGGAA-T--AAACGGA-TCCA-CGCGTGGATTT-CTGCATGTACCGT-ATGAATAAGGATCGGCTAACTCCGTG
Bacteroidetes_CAGTTCATAGGTCTGATTCGTC	--------------------AGAGGAAGGTCCCCCACATTGGAACTGAGACACGGTCCAAACTCCTACGGGAGGCAGCAGTGAGGAATATTGGTCAATGGACGAGAGTCTGAACCAGCCAAGTAGCGTGAAGGA-TGAAGG-TTCTA-TGGA-TTGTAAACTTCTTTTATACGGGAA-T--AAACGGA-TCCA-CGTGTGGATTT-TTGCATGTACCGT-ATGAATAAGGATCGGCTAACTCCGTG
Bacteroidetes_CAGTTCATGTATCTGAATCATC	--------------------AGAGGAAGGTCCCCCACATTGGAACTGAGACACGGTCCAAACTCCTACGGGAGGCAGCAGTGAGGAATATTGGTCAATGGACGAGAGTCTGAACCAGCCAAGTAGCGTGAAGGA-TGACTG-CCCTA-TGGG-TTGTAAACTTCTTTTATATGGGAA-T--AAAGTAT-TCCA-CGTGTGGAATT-TTGTATGTACCAT-ATGAATAAGGATCGGCTAACTCCGTG
Bacteroidetes_CAGTTCATGTATCTGGATCATC	--------------------AGAGGAAGGTCCCCCACATTGGAACTGAGACACGGTCCAAACTCCTACGGGAGGCAGCAGTGAGGAATATTGGTCAATGGACGAGAGTCTGAACCAGCCAAGTAGCGTGAAGGA-TGACTG-CCCTA-TGGG-TTGTAAACTTCTTTTATATGGGAA-T--AAAGTAT-TCCA-CGTGTGGGATT-TTGTATGTACCAT-ATGAATAAGGATCGGCTAACTCCGTG
Bacteroidetes_CAGTTCATGTGAGACTCCCGTC	--------------------AGAGGAAGGTCCCCCACATTGGAACTGAGACACGGTCCAAACTCCTACGGGAGGCAGCAGTGAGGAATATTGGTCAATGGACGAGAGTCTGAACCAGCCAAGTAGCGTGAAGGA-TGACTG-CCCTA-TGGG-TTGTAAACTTCTTTTATACGGGAA-T--AAAGTGG-AGTATGCA-TACTCCT-TTGTATGTACCGT-ATGAATAAGGATCGGCTAACTCCGTG
Bacteroidetes_CAGTTCATGTGGATTCTTCTTT	--------------------AGAGGAAGGTCCCCCACATTGGAACTGAGACACGGTCCAAACTCCTACGGGAGGCAGCAGTGAGGAATATTGGTCAATGGACGAGAGTCTGAACCAGCCAAGTAGCGTGCAGGA-TGACGG-CCCTA-TGGG-TTGTAAACTGCTTTTATAAGGGAA-T--AAAGTGA-GAGT-CGTGACTCTTT-TTGCATGTACCTT-ATGAATAAGGACCGGCTAATTCCGTG
Bacteroidetes_CAGTTCATGTGGCTGCTTCACC	--------------------AGAGGAAGGTCCCCCACATTGGAACTGAGACACGGTCCAAACTCCTACGGGAGGCAGCAGTGAGGAATATTGGTCAATGGACGAGAGTCTGAACCAGCCAAGTAGCGTGAAGGA-TGACTG-CCCTA-TGGG-TTGTAAACTTCTTTTATATGGGAA-T--AAAGTGA-GCCA-CGTGTGGCTTT-TTGTATGTACCAT-ACGAATAAGGATCGGCTAACTCCGTG
Bacteroidetes_CAGTTCATGTGGCTGCTTCGTC	--------------------AGAGGAAGGTCCCCCACATTGGAACTGAGACACGGTCCAAACTCCTACGGGAGGCAGCAGTGAGGAATATTGGTCAATGGACGAGAGTCTGAACCAGCCAAGTAGCGTGAAGGA-TGACTG-CCCTA-TGGG-TTGTAAACTTCTTTTATACGGGAA-T--AAAGTGA-GCCA-CGTGTGGCTTT-TTGTATGTACCGT-ATGAATAAGGATCGGCTAACTCCGTG
Bacteroidetes_CAGTTCATGTGGCTGTTTCGTC	--------------------AGAGGAAGGTCCCCCACATTGGAACTGAGACACGGTCCAAACTCCTACGGGAGGCAGCAGTGAGGAATATTGGTCAATGGACGAGAGTCTGAACCAGCCAAGTAGCGTGAAGGA-TGACTG-CCCTA-TGGG-TTGTAAACTTCTTTTATACGGGAA-T--AAAGTGA-GCCA-CGTGTGGTTTT-TTGTATGTACCGT-ATGAATAAGGATCGGCTAACTCCGTG
Bacteroidetes_CAGTTCATGTGGGCCCTTCGTC	--------------------AGAGGAAGGTCCCCCACATTGGAACTGAGACACGGTCCAAACTCCTACGGGAGGCAGCAGTGAGGAATATTGGTCAATGGACGAGAGTCTGAACCAGCCAAGTAGCGTGAAGGA-TGACTG-CCCTA-TGGG-TTGTAAACTTCTTTTATACGGGAA-T--AAAGTGA-GGCA-CGCGTGCCTTT-TTGTATGTACCGT-ATGAATAAGGATCGGCTAACTCCGTG
Bacteroidetes_CAGTTCATGTGGGTCCTTCGTC	--------------------AGAGGAAGGTCCCCCACATTGGAACTGAGACACGGTCCAAACTCCTACGGGAGGCAGCAGTGAGGAATATTGGTCAATGGACGAGAGTCTGAACCAGCCAAGTAGCGTGAAGGA-TGACTG-CCCTA-TGGG-TTGTAAACTTCTTTTATACGGGAA-T--AAAGTGA-GGCA-CGTGTGCCTTT-TTGTATGTACCGT-ATGAATAAGGATCGGCTAACTCCGTG
Bacteroidetes_CAGTTCATGTGGGTCTCTCGTT	--------------------AGAGGAAGGTCCCCCACACTGGAACTGAGACACGGTCCAGACTCCTACGGGAGGCAGCAGTGAGGAATATTGGTCAATGGACGAGAGTCTGAACCAGCCAAGTAGCGTGCAGGA-TGACTG-CCCTA-TGGG-TTGTAAACTGCTTTTATGCGGGGA-T--AAAGTGG-GGAA-CGTGTTCTCTA-TTGCAGGTACCGC-ATGAATAAGGACCGGCTAATTCCGTG
Bacteroidetes_CAGTTCATGTGTCTGATTCATC	--------------------AGAGGAAGGTCCCCCACATTGGAACTGAGACACGGTCCAAACTCCTACGGGAGGCAGCAGTGAGGAATATTGGTCAATGGACGAGAGTCTGAACCAGCCAAGTAGCGTGAAGGA-TGACTG-CCCTA-TGGG-TTGTAAACTTCTTTTATATGGGAA-T--AAAGTGG-TCCA-CGTGTGGATTT-TTGTATGTACCAT-ATGAATAAGGATCGGCTAACTCCGTG
Bacteroidetes_CAGTTCATGTTGCTGCTTCGTC	--------------------AGAGGAAGGTCCCCCACATTGGAACTGAGACACGGTCCAAACTCCTACGGGAGGCAGCAGTGAGGAATATTGGTCAATGGACGAGAGTCTGAACCAGCCAAGTAGCGTGAAGGA-TGACTG-CCCTA-TGGG-TTGTAAACTTCTTTTATACGGGAA-T--AAAGTTA-GCCA-CGTGTGGCTTT-TTGTATGTACCGT-ATGAATAAGGATCGGCTAACTCCGTG
Bacteroidetes_CAGTTCATGTTTCTGAATCATC	--------------------AGAGGAAGGTCCCCCACATTGGAACTGAGACACGGTCCAAACTCCTACGGGAGGCAGCAGTGAGGAATATTGGTCAATGGACGAGAGTCTGAACCAGCCAAGTAGCGTGAAGGA-TGACTG-CCCTA-TGGG-TTGTAAACTTCTTTTATATGGGAA-T--AAAGTTT-TCCA-CGTGTGGAATT-TTGTATGTACCAT-ATGAATAAGGATCGGCTAACTCCGTG
Bacteroidetes_CATCTCATGTCGGACCCGTTTC	--------------------AGAGGAAGGTCCCCCACATTGGAACTGAGACACGGTCCAAACTCCTACGGGAGGCAGCAGTGAGGAATATTGGTCAATGGGCGATGGCCTGAACCAGCCAAGTAGCGTGAAGGA-TGACTG-CCCTA-TGGG-TTGTAAACTTCTTTTATAAAGGAA-T--AAAGTCG-GGTATGCA-TACCCGT-TTGCATGTACTTT-ATGAATAAGGATCGGCTAACTCCGTG
Bacteroidetes_CCACACATGTGTGTCGTTCGTT	--------------------AGAGGAAGGTCCCCCACATTGGAACTGAGACACGGTCCAAACTCCTACGGGAGGCAGCAGTGAGGAATATTGGTCAATGGGCGCAAGCCTGAACCAGCCAAGTAGCGTGCAGGA-AGACGG-CCCTA-TGGG-TTGTAAACTGCTTTTATACGAGAA-T--AATTTGA-TGCA-CGTGTGCGTTA-TTGCATGTATCGT-ATGAATAAGGACCGGCTAATTCCGTG
Bacteroidetes_CCACCCATGCGCGTCGTCCGCT	--------------------AGAGGAAGGTCCCCCACATTGGAACTGAGACACGGTCCAAACTCCTACGGGAGGCAGCAGTGAGGAATATTGGTCAATGGGCGCAAGCCTGAACCAGCCAAGTAGCGTGCAGGA-CGACGG-CCCTA-TGGG-TTGTAAACTGCTTTTGTACGGGGA-T--AAAACGG-CGGA-CGTGTCCGTCC-TTGCAGGTACCGT-ACGAATAAGGACCGGCTAATTCCGTG
Bacteroidetes_CCACTCATGTCGGACCCGTTTC	--------------------AGAGGAAGGTCCCCCACATTGGAACTGAGACACGGTCCAAACTCCTACGGGAGGCAGCAGTGAGGAATATTGGTCAATGGGCGCAGGCCTGAACCAGCCAAGTAGCGTGAAGGA-TGACTG-CCCTA-TGGG-TTGTAAACTTCTTTTATAAAGGAA-T--AAAGTCG-GGTATGTA-TACCCGT-TTGCATGTACTTT-ATGAATAAGGATCGGCTAACTCCGTG
Bacteroidetes_CCACTCATGTTTCTGAATCATC	--------------------AGAGGAAGGTCCCCCACATTGGAACTGAGACACGGTCCAAACTCCTACGGGAGGCAGCAGTGAGGAATATTGGTCAATGGGCGCAGGCCTGAACCAGCCAAGTAGCGTGAAGGA-TGACTG-CCCTA-TGGG-TTGTAAACTTCTTTTATATGGGAA-T--AAAGTTT-TCCA-CGTGTGGAATT-TTGTATGTACCAT-ATGAATAAGGATCGGCTAACTCCGTG
Bacteroidetes_CCATA-CTGAGGGTCCTTCAAT	--------------------AGAGGAAGGTCCCCCACATTGGAACTGAGACACGGTCCAAACTCCTACGGGAGGCAGCAGTGAGGAATATTGGTCAATGGACGCAAGTCTGAACCAGCCAAGTAGCGTGCAGGA-AGACGGCCC-TC-TGGG-TTGTAAACTGCTTTTAGTTGGGAA-T--AAAAAGA-GGGA-CGTGTCCCTTA-TTGTATGTACCAT-CAGAAAAAGGACCGGCTAATTCCGTG
Bacteroidetes_CCATA-TCA--------TCAAC	CTACGATCTAAGCTGGTCTGAGAGGACGATCAGCCACATTGGAACTGAGACACGGTCCAGACTCCTACGGGAGGCAGCAGTGAGGAATATTGGGCAATGGAGGCAACTCTGACCCAGCCATGCCGCGTGA-GTG-AGAAGG-TT-TT-CGAA-TTGTAAAGCTCTTTCGGGTGTGAA-G--A---------------------TG-ATGACGGTAACAC-CAGAAGAAGCCCCGGCAAACTTCGTG
Bacteroidetes_CCATACATGGCCTTAGAGCGCC	--------------------AGAGGTTAACCCCCCACATTGGTACTGAGACACGGACCAAACTCCTACGGGAGGCAGCAGTGAGGAATATTGGTCAATGGACGCAAGTCTGAACCAGCCATGCCGCGTGCAGGA-AGACGG-CTCTA-TGAG-TTGTAAACTGCTTTTGTACGAGAG-T--AAACGCT-CTTA-CGTGTAAGAGC-CTGAAAGTATCGT-ACGAATAAGGATCGGCTAACTCCGTG
Bacteroidetes_CCATACATGGCTCCGGTGCGCC	--------------------AGAGGTCAACCCCCCACATTGGTACTGAGACACGGACCAAACTCCTACGGGAGGCAGCAGTGAGGAATATTGGTCAATGGACGCAAGTCTGAACCAGCCATGCCGCGTGCAGGA-AGACGG-CTCTA-TGAG-TTGTAAACTGCTTTTGTACGAGGG-T--AACAGCA-TCTA-CGCGTAGGTGC-ATGAAAGTATCGT-ACGAATAAGGATCGGCTAACTCCGTG
Bacteroidetes_CCATACATGGCTCTGGAGAGCC	--------------------AGAGGTTAACCCCCCACATTGGTACTGAGACACGGACCAAACTCCTACGGGAGGCAGCAGTGAGGAATATTGGTCAATGGACGCAAGTCTGAACCAGCCATGCCGCGTGCAGGA-AGACGG-CTCTA-TGAG-TTGTAAACTGCTTTTGTACTAGGG-T--AAACGCT-TCTA-CGTGTAGGAGC-CTGAAAGTATAGT-ACGAATAAGGATCGGCTAACTCCGTG
Bacteroidetes_CCATACATGTCCCTGGTGCGCC	--------------------AGAGGTTAACCCCCCACACTGGTACTGAGACACGGACCAGACTCCTACGGGAGGCAGCAGTGAGGAATATTGGTCAATGGACGCAAGTCTGAACCAGCCATGCCGCGTGCAGGA-AGACGG-CTCTA-TGAG-TTGTAAACTGCTTTTGTACGAGGG-T--AAACTCA-CCTA-CGTGTAGGTGA-CTGAAAGTATCGT-ACGAATAAGGATCGGCTAACTCCGTG
Bacteroidetes_CCATTCATGGCGATTCTGCGCC	--------------------AGAGGTTAACCCCCCACACTGGTACTGAGACACGGACCAGACTCCTACGGGAGGCAGCAGTGAGGAATATTGGTCAATGGACGCAAGTCTGAACCAGCCATGCCGCGTGCAGGA-TGACGG-CTCTA-TGAG-TTGTAAACTGCTTTTGTACGAGGG-T--AAACGCA-GATA-CGTGTATCTGT-CTGAAAGTATCGT-ACGAATAAGGATCGGCTAACTCCGTG
Bacteroidetes_CCATTCATGTGCGTCGCCCTTT	--------------------AGAGGAAGGTCCCCCACATTGGAACTGAGACACGGTCCAAACTCCTACGGGAGGCAGCAGTGAGGAATATTGGTCAATGGACGCAAGTCTGAACCAGCCAAGTAGCGTGCAGGA-TGACGG-CCCTA-TGGG-TTGTAAACTGCTTTTATGTGGGAA-T--AAAGTGG-CGCA-CGTGTGCGCCA-TTGCATGTACCTC-ATGAATAAGGACCGGCTAATTCCGTG
Bacteroidetes_CCATTCATGTTGGACTTACATT	--------------------AGAGGAAGGTCCCCCACATTGGAACTGAGACACGGTCCAAACTCCTACGGGAGGCAGCAGTGAGGAATATTGGTCAATGGATGCAAATCTGAACCAGCCAAGTAGCGTGCAGGA-TGACGG-CCCTA-TGGG-TTGTAAACTGCTTTTATGTGAGAA-T--AAAGTTA-GGTATGTA-TACTTAT-TTGCATGTATCAC-ATGAATAAGGACCGGCTAATTCCGTG
Bacteroidetes_CCATTCCCGAAAGTCTCTCTAT	--------------------AGAGGAAGGTCCCCCACACTGGAACTGAGACACGGTCCAGACTCCTACGGGAGGCAGCAGTGAGGAATATTGGTCAATGGACGCAAGTCTGAACCAGCCAAGTAGCGTGCAGGA-TGACGG-CCCTC-CGGG-TTGTAAACTGCTTTTAGTTGGGAA-T--AAAAAAG-AGGA-CGTGTCCTCTA-TTGTATGTACCTT-CAGAAAAAGGACCGGCTAATTCCGTG
Bacteroidetes_CCATTCCTGAAAGTCTCTCTAT	--------------------AGAGGAAGGTCCCCCACACTGGAACTGAGACACGGTCCAGACTCCTACGGGAGGCAGCAGTGAGGAATATTGGTCAATGGACGCAAGTCTGAACCAGCCAAGTAGCGTGCAGGA-TGACGG-CCCTC-TGGG-TTGTAAACTGCTTTTAGTTGGGAA-T--AAAAAAG-AGGA-CGTGTCCTCTA-TTGTATGTACCTT-CAGAAAAAGGACCGGCTAATTCCGTG
Bacteroidetes_CCGCT-ATGTCATTATTGCACT	--------------------AGAGGAAGGTCCCCCACATTGGAACTGAGACACGGTCCAAACTCCTACGGGAGGCAGCAGTGAGGAATATTGGTCAATGGGCGCGAGCCTGAACCAGCCAAGTAGCGTGCAGGA-TGACGGCCC-TA-TGGG-TTGTAAACTGCTTTTGTATGGGGA-T--AAAGTCA-ATCA-CGTGTGATTGT-TTGCAGGTACCAT-ACGAATAAGGACCGGCTAATTCCGTG
Bacteroidetes_CCGCT-ATGTTGGTCCTACACT	--------------------AGAGGAAGGTCCCCCACATTGGAACTGAGACACGGTCCAAACTCCTACGGGAGGCAGCAGTGAGGAATATTGGTCAATGGGCGCGAGCCTGAACCAGCCAAGTAGCGTGCAGGA-TGACGGCCC-TA-TGGG-TTGTAAACTGCTTTTGTATGGGGA-T--AAAGTTA-GGGA-CGTGTCCCTAT-TTGCAGGTACCAT-ACGAATAAGGACCGGCTAATTCCGTG
Bacteroidetes_CCGCT-TAGGAGGTCCGTCCCC	--------------------AGAGGTTGAACCCCCACACTGGTACTGAGACACGGACCAGACTCCTACGGGAGGCAGCAGTGAGGAATATTGGTCAATGGGCGCGAGCCTGAACCAGCCAAGTCGCGTGAAGGA-TGACTG-TC-TT-ATGGATTGTAAACTTCTTTTGTAGGGGAA-T--AACGGAC-GGTA-CGTGTACCGTA-GTGAATGTACCCT-ACGAATAAGCATCGGCTAACTCCGTG
Bacteroidetes_CCGCT-TTAAGGTTACTCCGTC	--------------------AGAGGTTTATCCCCCACACTGGTACTGAGACACGGACCAGACTCCTACGGGAGGCAGCAGTGAGGAATATTGGTCAATGGGCGCGAGCCTGAACCAGCCAAGTCGCGTGAAGGA-TGACTG-TC-TTATGGA-TTGTAAACTTCTTTTATACGGGAA-T--AACAAGA-GTCA-CGTGTGACTCC-CTGCATGTACCGT-ATGAATAAGCATCGGCTAACTCCGTG
Bacteroidetes_CCGCTCACATGCCTGGCTCGTC	--------------------AGAGGAAGGTCCCCCACATTGGAACTGAGACACGGTCCAAACTCCTACGGGAGGCAGCAGTGAGGAATATTGGTCAATGGGCGCGAGCCTGAACCAGCCAAGTAGCGTGAAGGA-TGAAGG-TCCTA-CGGA-TTGTAAACTTCTTTTATACGGGAA-T--AAAGTGG-CCTA-CGTGTAGGCTT-TTGCATGTACCGT-ATGAATAAGCATCGGCTAACTCCGTG
Bacteroidetes_CCGCTCATGTTTCTGAATCATC	--------------------AGAGGAAGGTCCCCCACATTGGAACTGAGACACGGTCCAAACTCCTACGGGAGGCAGCAGTGAGGAATATTGGTCAATGGGCGCGAGCCTGAACCAGCCAAGTAGCGTGAAGGA-TGAAGG-CTCTA-TGGG-TCGTAAACTTCTTTTATATGGGAA-T--AAAGTTT-TCCA-CGTGTGGAATT-TTGTATGTACCAT-ATGAATAAGGATCGGCTAACTCCGTG
Bacteroidetes_CCGTT-ATGTGTCTGATTCATC	--------------------AGAGGAAGGTCCCCCACATTGGAACTGAGACACGGTCCAAACTCCTACGGGAGGCAGCAGTGAGGAATATTGGTCAATGGACGCGAGTCTGAACCAGCCAAGTAGCGTGAAGGA-TGACTGCCC-TA-TGGG-TTGTAAACTTCTTTTATATGGGAA-T--AAAGTGG-TCCA-CGTGTGGATTT-TTGTATGTACCAT-ATGAATAAGGATCGGCTAACTCCGTG
Bacteroidetes_CCGTTCATGTGTCTGACTCATC	--------------------AGAGGAAGGTCCCCCACATTGGAACTGAGACACGGTCCAAACTCCTACGGGAGGCAGCAGTGAGGAATATTGGTCAATGGACGCGAGTCTGAACCAGCCAAGTAGCGTGAAGGA-TGACTG-CCCTA-TGGG-TTGTAAACTTCTTTTATATGGGAA-T--AAAGTGG-TCCA-CGTGTGGACTT-TTGTATGTACCAT-ATGAATAAGGATCGGCTAACTCCGTG
Bacteroidetes_CCGTTCATGTTTCTGATTCATC	--------------------AGAGGAAGGTCCCCCACATTGGAACTGAGACACGGTCCAAACTCCTACGGGAGGCAGCAGTGAGGAATATTGGTCAATGGACGCGAGTCTGAACCAGCCAAGTAGCGTGAAGGA-TGACTG-CCCTA-TGGG-TTGTAAACTTCTTTTATATGGGAA-T--AAAGTTG-TCCA-CGTGTGGATTT-TTGTATGTACCAT-ATGAATAAGGATCGGCTAACTCCGTG
Bacteroidetes_CCTCTCATGTGAGACTGTTATC	--------------------AGAGGAAGGTCCCCCACATTGGAACTGAGACACGGTCCAAACTCCTACGGGAGGCAGCAGTGAGGAATATTGGTCAATGGGCGCTAGCCTGAACCAGCCAAGTAGCGTGAAGGA-TGAAGG-CTCTA-TGGG-TCGTAAACTTCTTTTATATAAGAA-T--AAAGTGC-AGTATGTA-TACTGTT-TTGTATGTATTAT-ATGAATAAGGATCGGCTAACTCCGTG
Bacteroidetes_CGAAATATGAGACAGTTTTCCC	--------------------AGAGGGATATCCCCCACACTGGTACTGAGATACGGACCAGACTCCTACGGGAGGCAGCAGTGAGGAATATTGGACAATGGTCGGAAGACTGATCCAGCCATGCCGCGTGCAGGA-AGACGG-CCTTA-TGGG-TTGTAAACTGCTTTTGCAGGGGAA-G--AATAAGG-ACTA-CGAGTAGTTTG-ATGACGGTACTCT-GCGAATAAGCATCGGCTAACTCCGTG
Bacteroidetes_CGAAATATGAGACCGTTTTCCC	--------------------AGAGGGATATCCCCCACACTGGTACTGAGATACGGACCAGACTCCTACGGGAGGCAGCAGTGAGGAATATTGGACAATGGTCGGAAGACTGATCCAGCCATGCCGCGTGCAGGA-AGACGG-CCTTA-TGGG-TTGTAAACTGCTTTTGCAGGGGAA-G--AATAAGG-ACTA-CGCGTAGTTTG-ATGACGGTACTCT-GCGAATAAGCATCGGCTAACTCCGTG
Bacteroidetes_CGAAATATGAGACTGTTTTCCC	--------------------AGAGGGATATCCCCCACACTGGTACTGAGATACGGACCAGACTCCTACGGGAGGCAGCAGTGAGGAATATTGGACAATGGTCGGAAGACTGATCCAGCCATGCCGCGTGCAGGA-AGACGG-CCTTA-TGGG-TTGTAAACTGCTTTTGCAGGGGAA-G--AATAAGG-ACTA-CGTGTAGTTTG-ATGACGGTACTCT-GCGAATAAGCATCGGCTAACTCCGTG
Bacteroidetes_CGAAATATGAGAGCCTTTCATC	--------------------AGAGGGAGATCCCCCACACTGGTACTGAGACAGGGACCAGACTCCTACGGGAGGCAGCAGTGAGGAATATTGGTCAATGGTCGGAAGACTGAACCAGCCATGCCGCGTGCAGGA-AGAATG-CCTTA-TGGG-TTGTAAACTGCTTTTATATGGGAA-G--AATAAGG-AGTA-CGCGTACTTTG-ATGACGGTACCAT-ATGAATAAGCATCGGCTAACTCCGTG
Bacteroidetes_CGAAATATGAGAGTCTCTTATC	--------------------AGAGGGAGATCCCCCACACTGGTACTGAGACAGGGACCAGACTCCTACGGGAGGCAGCAGTGAGGAATATTGGTCAATGGTCGGAAGACTGAACCAGCCATGCCGCGTGCAGGA-AGAATG-CCTTA-TGGG-TTGTAAACTGCTTTTATATAGGGA-G--AATAAGG-AGTA-CGTGTACTCTG-ATGACGGTACTAT-ATGAATAAGCATCGGCTAACTCCGTG
Bacteroidetes_CGAAATATGAGAGTCTTTCATC	--------------------AGAGGGAGATCCCCCACACTGGTACTGAGACAGGGACCAGACTCCTACGGGAGGCAGCAGTGAGGAATATTGGTCAATGGTCGGAAGACTGAACCAGCCATGCCGCGTGCAGGA-AGAATG-CCTTA-TGGG-TTGTAAACTGCTTTTATATGGGAA-G--AATAAGG-AGTA-CGTGTACTTTG-ATGACGGTACCAT-ATGAATAAGCATCGGCTAACTCCGTG
Bacteroidetes_CGAAATATGAGAGTCTTTTCCC	--------------------AGAGGGATATCCCCCACACTGGTACTGAGATACGGACCAGACTCCTACGGGAGGCAGCAGTGAGGAATATTGGACAATGGTCGGAAGACTGATCCAGCCATGCCGCGTGCAGGA-AGACGG-CCTTA-TGGG-TTGTAAACTGCTTTTGCAGGGGAA-G--AATAAGG-AGTA-CGTGTACTTTG-ATGACGGTACTCT-GCGAATAAGCATCGGCTAACTCCGTG
Bacteroidetes_CGAAATATGAGAGTCTTTTCTC	--------------------AGAGGGATATCCCCCACACTGGTACTGAGATACGGACCAGACTCCTACGGGAGGCAGCAGTGAGGAATATTGGACAATGGTCGGAAGACTGATCCAGCCATGCCGCGTGCAGGA-AGACGG-CCTTA-TGGG-TTGTAAACTGCTTTTGCAGGGGAA-G--AATAAGG-AGTA-CGTGTACTTTG-ATGACGGTACTCT-GTGAATAAGCATCGGCTAACTCCGTG
Bacteroidetes_CGAAATATGAGCGACGGCTTCC	--------------------AGAGGGAGATCCCCCACACTGGTACTGAGACACGGACCAGACTCCTACGGGAGGCAGCAGTGAGGAATATTGGTCAATGGTCGGAAGACTGAACCAGCCATGCCGCGTGCAGGA-AGACGG-CCTTA-TGGG-TTGTAAACTGCTTTTGTAAGGGAA-G--AATAAGT-CGTATGTA-TACGGCG-ATGACGGTACTTT-ACGAATAAGCATCGGCTAACTCCGTG
Bacteroidetes_CGAAATATGAGCGACGTTCATC	--------------------AGAGGGAGATCCCCCACACTGGTACTGAGACAGGGACCAGACTCCTACGGGAGGCAGCAGTGAGGAATATTGGTCAATGGTCGGAAGACTGAACCAGCCATGCCGCGTGCAGGA-AGAATG-CCTTA-TGGG-TTGTAAACTGCTTTTATATGGGAA-G--AATAAGG-CGTA-CGAGTACGTTG-ATGACGGTACCAT-ATGAATAAGCATCGGCTAACTCCGTG
Bacteroidetes_CGAAATATGAGCGTCGTTCATC	--------------------AGAGGGAGATCCCCCACACTGGTACTGAGACAGGGACCAGACTCCTACGGGAGGCAGCAGTGAGGAATATTGGTCAATGGTCGGAAGACTGAACCAGCCATGCCGCGTGCAGGA-AGAATG-CCTTA-TGGG-TTGTAAACTGCTTTTATATGGGAA-G--AATAAGG-CGTA-CGTGTACGTTG-ATGACGGTACCAT-ATGAATAAGCATCGGCTAACTCCGTG
Bacteroidetes_CGAAATATGAGTGACATTCATC	--------------------AGAGGGAGATCCCCCACACTGGTACTGAGACAGGGACCAGACTCCTACGGGAGGCAGCAGTGAGGAATATTGGTCAATGGTCGGAAGACTGAACCAGCCATGCCGCGTGCAGGA-AGAATG-CCTTA-TGGG-TTGTAAACTGCTTTTATATGGGAA-G--AATAAGG-TGTA-CGAGTACATTG-ATGACGGTACCAT-ATGAATAAGCATCGGCTAACTCCGTG
Bacteroidetes_CGAAATATGAGTGTCATTCATC	--------------------AGAGGGAGATCCCCCACACTGGTACTGAGACAGGGACCAGACTCCTACGGGAGGCAGCAGTGAGGAATATTGGTCAATGGTCGGAAGACTGAACCAGCCATGCCGCGTGCAGGA-AGAATG-CCTTA-TGGG-TTGTAAACTGCTTTTATATGGGAA-G--AATAAGG-TGTA-CGTGTACATTG-ATGACGGTACCAT-ATGAATAAGCATCGGCTAACTCCGTG
Bacteroidetes_CGAATCATAAGAGTCTTTCTCC	--------------------AGAGGGATGTCCCCCACACTGGTACTGAGATACGGACCAGACTCCTACGGGAGGCAGCAGTGAGGAATATTGGACAATGGTCGGAAGACTGATCCAGCCATGCCGCGTGCAGGA-TGAAGG-TCCTA-TGGA-TTGTAAACTGCTTTTGTAAGGGAA-G--AATAAGG-AGTA-CGTGTACTTTG-ATGACGGTACCTT-ACGAATAAGCATCGGCTAACTCCGTG
Bacteroidetes_CGAATCATAAGGGTCTTTCTCC	--------------------AGAGGGATGTCCCCCACACTGGTACTGAGATACGGACCAGACTCCTACGGGAGGCAGCAGTGAGGAATATTGGACAATGGTCGGAAGACTGATCCAGCCATGCCGCGTGCAGGA-TGAAGG-TCCTA-TGGA-TTGTAAACTGCTTTTGTAAGGGAA-G--AATAAGG-GGTA-CGTGTACTTTG-ATGACGGTACCTT-ACGAATAAGCATCGGCTAACTCCGTG
Bacteroidetes_CGAATTATAAGACTGTTTCTTC	--------------------AGAGGGATGTCCCCCACACTGGTACTGAGATACGGACCAGACTCCTACGGGAGGCAGCAGTGAGGAATATTGGACAATGGTCGGAAGACTGATCCAGCCATGCCGCGTGCAGGA-TGAAGG-TCTTA-TGGA-TTGTAAACTGCTTTTGTAAGGGAA-G--AATAAGG-ACTA-CGTGTAGTTTG-ATGACGGTACCTT-ATGAATAAGCATCGGCTAACTCCGTG
Bacteroidetes_CGAATTATAAGACTGTTTTCTC	--------------------AGAGGGATGTCCCCCACACTGGTACTGAGATACGGACCAGACTCCTACGGGAGGCAGCAGTGAGGAATATTGGACAATGGTCGGAAGACTGATCCAGCCATGCCGCGTGCAGGA-TGAAGG-TCTTA-TGGA-TTGTAAACTGCTTTTGCAGGGGAA-G--AATAAGG-ACTA-CGTGTAGTTTG-ATGACGGTACTCT-GTGAATAAGCATCGGCTAACTCCGTG
Bacteroidetes_CGAATTATAAGAGACTTTCTTC	--------------------AGAGGGATGTCCCCCACACTGGTACTGAGATACGGACCAGACTCCTACGGGAGGCAGCAGTGAGGAATATTGGACAATGGTCGGAAGACTGATCCAGCCATGCCGCGTGCAGGA-TGAAGG-TCTTA-TGGA-TTGTAAACTGCTTTTGTAAGGGAA-G--AATAAGG-AGTA-CGAGTACTTTG-ATGACGGTACCTT-ATGAATAAGCATCGGCTAACTCCGTG
Bacteroidetes_CGAATTATAAGGCCGTTTCTCC	--------------------AGAGGGATGTCCCCCACACTGGTACTGAGATACGGACCAGACTCCTACGGGAGGCAGCAGTGAGGAATATTGGACAATGGTCGGAAGACTGATCCAGCCATGCCGCGTGCAGGA-TGAAGG-TCTTA-TGGA-TTGTAAACTGCTTTTGTAAGGGAA-G--AATAAGG-GCTA-CGCGTAGTTTG-ATGACGGTACCTT-ACGAATAAGCATCGGCTAACTCCGTG
Bacteroidetes_CGAATTATAAGGCCGTTTCTTC	--------------------AGAGGGATGTCCCCCACACTGGTACTGAGATACGGACCAGACTCCTACGGGAGGCAGCAGTGAGGAATATTGGACAATGGTCGGAAGACTGATCCAGCCATGCCGCGTGCAGGA-TGAAGG-TCTTA-TGGA-TTGTAAACTGCTTTTGTAAGGGAA-G--AATAAGG-GCTA-CGCGTAGTTTG-ATGACGGTACCTT-ATGAATAAGCATCGGCTAACTCCGTG
Bacteroidetes_CGAATTATGAGACTGTTTCTCC	--------------------AGAGGGATGTCCCCCACACTGGTACTGAGATACGGACCAGACTCCTACGGGAGGCAGCAGTGAGGAATATTGGACAATGGTCGGAAGACTGATCCAGCCATGCCGCGTGCAGGA-TGACGG-CCTTA-TGGG-TTGTAAACTGCTTTTGTAAGGGAA-G--AATAAGG-ACTA-CGTGTAGTTTG-ATGACGGTACCTT-ACGAATAAGCATCGGCTAACTCCGTG
Bacteroidetes_CGAATTATGAGAGACTTTCTCC	--------------------AGAGGGATGTCCCCCACACTGGTACTGAGATACGGACCAGACTCCTACGGGAGGCAGCAGTGAGGAATATTGGACAATGGTCGGAAGACTGATCCAGCCATGCCGCGTGCAGGA-TGACGG-CCTTA-TGGG-TTGTAAACTGCTTTTGTAAGGGAA-G--AATAAGG-AGTA-CGAGTACTTTG-ATGACGGTACCTT-ACGAATAAGCATCGGCTAACTCCGTG
Bacteroidetes_CGAATTATGAGAGTCTTTCTCC	--------------------AGAGGGATGTCCCCCACACTGGTACTGAGATACGGACCAGACTCCTACGGGAGGCAGCAGTGAGGAATATTGGACAATGGTCGGAAGACTGATCCAGCCATGCCGCGTGCAGGA-TGACGG-CCTTA-TGGG-TTGTAAACTGCTTTTGTAAGGGAA-G--AATAAGG-AGTA-CGTGTACTTTG-ATGACGGTACCTT-ACGAATAAGCATCGGCTAACTCCGTG
Bacteroidetes_CGAATTATGAGAGTCTTTCTTC	--------------------AGAGGGATGTCCCCCACACTGGTACTGAGATACGGACCAGACTCCTACGGGAGGCAGCAGTGAGGAATATTGGACAATGGTCGGAAGACTGATCCAGCCATGCCGCGTGCAGGA-TGACGG-CCTTA-TGGG-TTGTAAACTGCTTTTGTAAGGGAA-G--AATAAGG-AGTA-CGTGTACTTTG-ATGACGGTACCTT-ATGAATAAGCATCGGCTAACTCCGTG
Bacteroidetes_CGAATTATGAGGCCGTTTCTTC	--------------------AGAGGGATGTCCCCCACACTGGTACTGAGATACGGACCAGACTCCTACGGGAGGCAGCAGTGAGGAATATTGGACAATGGTCGGAAGACTGATCCAGCCATGCCGCGTGCAGGA-TGACGG-CCTTA-TGGG-TTGTAAACTGCTTTTGTAAGGGAA-G--AATAAGG-GCTA-CGCGTAGTTTG-ATGACGGTACCTT-ATGAATAAGCATCGGCTAACTCCGTG
Bacteroidetes_CGACA-ATGTGGGTCTTCCGTT	--------------------AGAGGAAGGTCCCCCACATTGGAACTGAGACACGGTCCAAACTCCTACGGGAGGCAGCAGTGAGGAATATTGGTCAATGGGCGGAAGCCTGAACCAGCCAAGTAGCGTGCAGGA-AGACGGCCC-TA-TGGG-TTGTAAACTGCTTTTATGCGGGGA-T--AAAGTGA-GGGA-CGTGTCCTTCA-TTGCAGGTACCGC-ATGAATAAGGACCGGCTAATTCCGTG
Bacteroidetes_CGACA-ATGTGTGTCGTTCGTT	--------------------AGAGGAAGGTCCCCCACATTGGAACTGAGACACGGTCCAAACTCCTACGGGAGGCAGCAGTGAGGAATATTGGTCAATGGGCGGAAGCCTGAACCAGCCAAGTAGCGTGCAGGA-AGACGGCCC-TA-TGGG-TTGTAAACTGCTTTTATACGAGAA-T--AATTTGA-TGCA-CGTGTGCGTTA-TTGCATGTATCGT-ATGAATAAGGACCGGCTAATTCCGTG
Bacteroidetes_CGACACATACTCCTGGTACATC	--------------------AGAGGGTGATCCCCCACACTGGGACTGAGACACGGCCCAGACTCCTACGGGAGGCAGCAGTGAGGAATATTGGACAATGGGTGGAAGCCTGATCCAGCCATCCCGCGTGAAGGA-AGACGG-TTCTA-TGGA-TTGTAAACTTCTTTTATATGGGGA-T--AAACCTA-CCCT-CGTGAGGGTAG-CTGAAGGTACCAT-ATGAATAAGCACCGGCTAACTCCGTG
Bacteroidetes_CGACCCATACTCCTGGTACATC	--------------------AGAGGGTGATCCCCCACACTGGGACTGAGACACGGCCCAGACTCCTACGGGAGGCAGCAGTGAGGAATATTGGACAATGGGTGGAAGCCTGATCCAGCCATCCCGCGTGAAGGA-CGACGG-TTCTA-TGGA-TTGTAAACTTCTTTTATATGGGGA-T--AAACCTA-CCCT-CGTGAGGGTAG-CTGAAGGTACCAT-ATGAATAAGCACCGGCTAACTCCGTG
Bacteroidetes_CGACCCATGCTCTTAGTATATC	--------------------AGAGGGTGATCCCCCACACTGGGACTGAGACACGGCCCAGACTCCTACGGGAGGCAGCAGTGAGGAATATTGGACAATGGGTGGAAGCCTGATCCAGCCATCCCGCGTGCAGGA-CGACTG-CCCTA-TGGG-TTGTAAACTGCTTTTATATAGGGA-T--AAACCTA-CTCT-CGTGAGAGTAG-CTGAAGGTACTAT-ATGAATAAGCACCGGCTAACTCCGTG
Bacteroidetes_CGACGCACGTGGGCCCTTCGTT	--------------------AGAGGAAGGTCCCCCACATTGGAACTGAGACACGGTCCAAACTCCTACGGGAGGCAGCAGTGAGGAATATTGGTCAATGGGCGGAAGCCTGAACCAGCCAAGTAGCGTGCAGGA-GGACGG-CCCTA-CGGG-TTGTAAACTGCTTTTATGCGGGGA-T--AAAGTGA-GGGA-CGCGTCCCTTT-TTGCAGGTACCGC-ATGAATAAGGACCGGCTAATTCCGTG
Bacteroidetes_CGACT-ATGTGGGTCTTCCGTT	--------------------AGAGGAAGGTCCCCCACATTGGAACTGAGACACGGTCCAAACTCCTACGGGAGGCAGCAGTGAGGAATATTGGTCAATGGGCGGAAGCCTGAACCAGCCAAGTAGCGTGCAGGA-TGACGGCCC-TA-TGGG-TTGTAAACTGCTTTTATGCGGGGA-T--AAAGTGA-GGGA-CGTGTCCTTCA-TTGCAGGTACCGC-ATGAATAAGGACCGGCTAATTCCGTG
Bacteroidetes_CGACT-TAGGATTCGACAAGGC	-------------------GAGAGGGTGGTCCCCCACACTGGGACTGAGACACGGCCCAGACTCCTACGGGAGGCAGCAGTAGGGAATATTGGTCAATGGGCGGAAGCCTGAACCAGCCATGCCGCGTGATGGA-TGACGG-CC-TT-AGGG-TTGTAAACATCTTTTCTGCTAGAG-G--AATAGAG-TTCA-CGCGTGGACAG-ACGACTGTATAGC-AGGAATAAGGATCGGCTAACTCCGTG
Bacteroidetes_CGACTCACGTGGGCCCTTCGTT	--------------------AGAGGAAGGTCCCCCACATTGGAACTGAGACACGGTCCAAACTCCTACGGGAGGCAGCAGTGAGGAATATTGGTCAATGGGCGGAAGCCTGAACCAGCCAAGTAGCGTGCAGGA-TGACGG-CCCTA-CGGG-TTGTAAACTGCTTTTATGCGGGGA-T--AAAGTGA-GGGA-CGCGTCCCTTT-TTGCAGGTACCGC-ATGAATAAGGACCGGCTAATTCCGTG
Bacteroidetes_CGATA-ATGTGTGTCGTTCGTT	--------------------AGAGGAAGGTCCCCCACATTGGAACTGAGACACGGTCCAAACTCCTACGGGAGGCAGCAGTGAGGAATATTGGTCAATGGACGGAAGTCTGAACCAGCCAAGTAGCGTGCAGGA-AGACGGCCC-TA-TGGG-TTGTAAACTGCTTTTATACGAGAA-T--AATTTGA-TGCA-CGTGTGCGTTA-TTGCATGTATCGT-ATGAATAAGGACCGGCTAATTCCGTG
Bacteroidetes_CGATA-ATGTTGGTCCTACACT	--------------------AGAGGAAGGTCCCCCACATTGGAACTGAGACACGGTCCAAACTCCTACGGGAGGCAGCAGTGAGGAATATTGGTCAATGGACGGAAGTCTGAACCAGCCAAGTAGCGTGCAGGA-AGACGGCCC-TA-TGGG-TTGTAAACTGCTTTTGTATGGGGA-T--AAAGTTA-GGGA-CGTGTCCCTAT-TTGCAGGTACCAT-ACGAATAAGGACCGGCTAATTCCGTG
Bacteroidetes_CGATT-ATGTCATTATTGCACT	--------------------AGAGGAAGGTCCCCCACATTGGAACTGAGACACGGTCCAAACTCCTACGGGAGGCAGCAGTGAGGAATATTGGTCAATGGACGGAAGTCTGAACCAGCCAAGTAGCGTGCAGGA-TGACGGCCC-TA-TGGG-TTGTAAACTGCTTTTGTATGGGGA-T--AAAGTCA-ATCA-CGTGTGATTGT-TTGCAGGTACCAT-ACGAATAAGGACCGGCTAATTCCGTG
Bacteroidetes_CGATT-CTGAAAGTCTCTCTAT	--------------------AGAGGAAGGTCCCCCACACTGGAACTGAGACACGGTCCAGACTCCTACGGGAGGCAGCAGTGAGGAATATTGGTCAATGGACGGAAGTCTGAACCAGCCAAGTAGCGTGCAGGA-TGACGGCCC-TC-TGGG-TTGTAAACTGCTTTTAGTTGGGAA-T--AAAAAAG-AGGA-CGTGTCCTCTA-TTGTATGTACCTT-CAGAAAAAGGACCGGCTAATTCCGTG
Bacteroidetes_CGATTCATGTTGGACTTACATT	--------------------AGAGGAAGGTCCCCCACATTGGAACTGAGACACGGTCCAAACTCCTACGGGAGGCAGCAGTGAGGAATATTGGTCAATGGATGGAAATCTGAACCAGCCAAGTAGCGTGCAGGA-TGACGG-CCCTA-TGGG-TTGTAAACTGCTTTTATGTGAGAA-T--AAAGTTA-GGTATGTA-TACTTAT-TTGCATGTATCAC-ATGAATAAGGACCGGCTAATTCCGTG
Bacteroidetes_CGATTCATGTTGGTCCTACACT	--------------------AGAGGAAGGTCCCCCACATTGGAACTGAGACACGGTCCAAACTCCTACGGGAGGCAGCAGTGAGGAATATTGGTCAATGGACGGAAGTCTGAACCAGCCAAGTAGCGTGCAGGA-TGACGG-CCCTA-TGGG-TTGTAAACTGCTTTTGTATGGGGA-T--AAAGTTA-GGGA-CGTGTCCCTAT-TTGCAGGTACCAT-ACGAATAAGGACCGGCTAATTCCGTG
Bacteroidetes_CGATTCATGTTGGTCCTACATT	--------------------AGAGGAAGGTCCCCCACATTGGAACTGAGACACGGTCCAAACTCCTACGGGAGGCAGCAGTGAGGAATATTGGTCAATGGACGGAAGTCTGAACCAGCCAAGTAGCGTGCAGGA-TGACGG-CCCTA-TGGG-TTGTAAACTGCTTTTGTATGGGGA-T--AAAGTTA-GGGA-CGTGTCCCTAT-TTGCAGGTACCAT-ATGAATAAGGACCGGCTAATTCCGTG
Bacteroidetes_CGATTCCCGAAAGTCTCTCTAT	--------------------AGAGGAAGGTCCCCCACACTGGAACTGAGACACGGTCCAGACTCCTACGGGAGGCAGCAGTGAGGAATATTGGTCAATGGACGGAAGTCTGAACCAGCCAAGTAGCGTGCAGGA-TGACGG-CCCTC-CGGG-TTGTAAACTGCTTTTAGTTGGGAA-T--AAAAAAG-AGGA-CGTGTCCTCTA-TTGTATGTACCTT-CAGAAAAAGGACCGGCTAATTCCGTG
Bacteroidetes_CGATTCCCGAGGGTCCTACTAT	--------------------AGAGGAAGGTCCCCCACACTGGAACTGAGACACGGTCCAGACTCCTACGGGAGGCAGCAGTGAGGAATATTGGTCAATGGACGGAAGTCTGAACCAGCCAAGTAGCGTGCAGGA-TGACGG-CCCTC-CGGG-TTGTAAACTGCTTTTAGTTGGGAA-T--AAAAAGA-GGGA-CGTGTCCCTAA-TTGTATGTACCTT-CAGAAAAAGGACCGGCTAATTCCGTG
Bacteroidetes_CGCAACACGTAGCTGCGTCCAC	--------------------AGAGGAAGGTCCCCCACATTGGAACTGAGACACGGTCCAAACTCCTACGGGAGGCAGCAGTGAGGAATATTGGTCAATGGTCGGCAGACTGAACCAGCCAAGTCGCGTGAGGGA-AGACGG-CCCTA-CGGG-TTGTAAACCTCTTTTGTCGGAGAG-T--AAAGTAC-GCTA-CGTGTAGCGTA-TTGCAAGTATCCG-AAGAAAAAGCATCGGCTAACTCCGTG
Bacteroidetes_CGCAACACGTAGCTGTGTCCAC	--------------------AGAGGAAGGTCCCCCACATTGGAACTGAGACACGGTCCAAACTCCTACGGGAGGCAGCAGTGAGGAATATTGGTCAATGGTCGGCAGACTGAACCAGCCAAGTCGCGTGAGGGA-AGACGG-CCCTA-CGGG-TTGTAAACCTCTTTTGTCGGAGAG-T--AAAGTAC-GCTA-CGTGTAGTGTA-TTGCAAGTATCCG-AAGAAAAAGCATCGGCTAACTCCGTG
Bacteroidetes_CGGCATATACTCTAGGTATATC	--------------------AGAGGGAGATCCCCCACACTGGGACTGAGACACGGCCCAGACTCCTACGGGAGGCAGCAGTGAGGAATATTGGACAATGGGTGGGAGCCTGATCCAGCCATTCCGCGTGCAGGA-AGAAGG-TCTTA-TGGA-TTGTAAACTGCTTTTATATAGGGA-T--AAACCTA-CTCT-CGAGAGGGTAG-CTGAAGGTACTAT-ATGAATAAGCACCGGCTAACTCCGTG
Bacteroidetes_CGGCATATACTCTCGGTATATC	--------------------AGAGGGAGATCCCCCACACTGGGACTGAGACACGGCCCAGACTCCTACGGGAGGCAGCAGTGAGGAATATTGGACAATGGGTGGGAGCCTGATCCAGCCATTCCGCGTGCAGGA-AGAAGG-TCTTA-TGGA-TTGTAAACTGCTTTTATATAGGGA-T--AAACCTA-CTCT-CGCGAGGGTAG-CTGAAGGTACTAT-ATGAATAAGCACCGGCTAACTCCGTG
Bacteroidetes_CGGCCCACGTTGCTGTGTCTTT	--------------------AGAGGAAGGTCCCCCACATTGGAACTGAGACACGGTCCAAACTCCTACGGGAGGCAGCAGTGAGGAATATTGGTCAATGGGCGGGAGCCTGAACCAGCCAAGTAGCGTGAAGGA-CGACGG-CCCTA-CGGG-TTGTAAACTTCTTTTATAAGGGAA-T--AAAGTTC-GCCA-CGTGTGGTGTT-TTGTATGTACCTT-ATGAATAAGCATCGGCTAATTCCGTG
Bacteroidetes_CGGTTCATGTGTCTGATTCGTC	--------------------AGAGGAAGGTCCCCCACATTGGAACTGAGACACGGTCCAAACTCCTACGGGAGGCAGCAGTGAGGAATATTGGTCAATGGACGGGAGTCTGAACCAGCCAAGTAGCGTGAAGGA-TGACTG-CCCTA-TGGG-TTGTAAACTTCTTTTATACGGGAA-T--AAAGTGA-TCCA-CGTGTGGATTT-TTGTATGTACCGT-ATGAATAAGGATCGGCTAACTCCGTG
Bacteroidetes_CTACACATACTCCTGGTATGTC	--------------------AGAGGGAGATCCCCCACACTGGGACTGAGACACGGCCCAGACTCCTACGGGAGGCAGCAGTGAGGAATATTGGACAATGGGTGTAAGCCTGATCCAGCCATCCCGCGTGAAGGA-AGACGG-TTCTA-TGGA-TTGTAAACTTCTTTTATACAGGGA-T--AAACCTA-CCCT-CGTGAGGGTAG-CTGAAGGTACTGT-ATGAATAAGCACCGGCTAACTCCGTG
Bacteroidetes_CTACTCATATGGGTCCGTCTTC	--------------------AGAGGAAGGTCCCCCACATTGGTACTGAGACACGGACCAAACTCCTACGGGAGGCAGCAGTGAGGAATATTGGTCAATGGGCGTAAGCCTGAACCAGCCAAGTCGCGTGAGGGA-TGAAGG-TTCTA-TGGA-TCGTAAACCTCTTTTATAAGGGAA-T--AAAGTGC-GGGA-CGTGTCCCGTT-TTGTATGTACCTT-ATGAATAAGGATCGGCTAACTCCGTG
Bacteroidetes_CTACTCATGGACCTGGCTCGTT	--------------------AGAGGAAGGTCCCCCACACTGGAACTGAGACACGGTCCAGACTCCTACGGGAGGCAGCAGTGAGGAATATTGGTCAATGGGCGTAAGCCTGAACCAGCCAAGTAGCGTGCAGGA-TGACGG-CCCTA-TGGG-TTGTAAACTGCTTTTATGCGGGGA-T--AAAGGAG-CCCA-CGTGTGGGCTT-TTGCAGGTACCGC-ATGAATAAGGACCGGCTAATTCCGTG
Bacteroidetes_CTACTCATGGACCTGGTTCGTT	--------------------AGAGGAAGGTCCCCCACACTGGAACTGAGACACGGTCCAGACTCCTACGGGAGGCAGCAGTGAGGAATATTGGTCAATGGGCGTAAGCCTGAACCAGCCAAGTAGCGTGCAGGA-TGACGG-CCCTA-TGGG-TTGTAAACTGCTTTTATGCGGGGA-T--AAAAGAG-CCCA-CGTGTGGGTTT-TTGCAGGTACCGC-ATGAATAAGGACCGGCTAATTCCGTG
Bacteroidetes_CTACTCATGTGCCTGGCTCGTT	--------------------AGAGGAAGGTCCCCCACACTGGAACTGAGACACGGTCCAGACTCCTACGGGAGGCAGCAGTGAGGAATATTGGTCAATGGGCGTAAGCCTGAACCAGCCAAGTAGCGTGCAGGA-TGACGG-CCCTA-TGGG-TTGTAAACTGCTTTTATGCGGGGA-T--AAAGTGG-CCCA-CGTGTGGGCTT-TTGCAGGTACCGC-ATGAATAAGGACCGGCTAATTCCGTG
Bacteroidetes_CTACTCATGTGCCTGGTTCGTT	--------------------AGAGGAAGGTCCCCCACACTGGAACTGAGACACGGTCCAGACTCCTACGGGAGGCAGCAGTGAGGAATATTGGTCAATGGGCGTAAGCCTGAACCAGCCAAGTAGCGTGCAGGA-TGACGG-CCCTA-TGGG-TTGTAAACTGCTTTTATGCGGGGA-T--AAAGTGG-CCCA-CGTGTGGGTTT-TTGCAGGTACCGC-ATGAATAAGGACCGGCTAATTCCGTG
Bacteroidetes_CTATACATGAGTCTGAATCTTC	--------------------AGAGGAAGGTCCCCCACATTGGAACTGAGACACGGTCCAAACTCCTACGGGAGGCAGCAGTGAGGAATATTGGTCAATGGACGTAAGTCTGAACCAGCCAAGTCGCGTGAGGGA-AGACTG-CCCTA-TGGG-TTGTAAACCTCTTTTATAAGGGAA-G--AATAAGT-TCTA-CGTGTAGAATG-ATGCCTGTACCTT-ATGAATAAGCATCGGCTAACTCCGTG
Bacteroidetes_CTATT-ATGTGGGCCCTTCCCT	---------------------GAGGAAGGTCCCCCACATTGGAACTGAGACACGGTCCAAACTCCTACGGGAGGCAGCAGTGAGGAATATTGGTCAATGGACGTAAGTCTGAACCAGCCAAGTAGCGTGCAGGATTGACGGCCC-TA-TGGG-TTGTAAACTGCTTTTGTTGGGGAG-T--AAAGTGA-GGCA-CGCGTGCCTTT-TTGCATTTACCCT-TCGAATAAGGACCGGCTAATTCCGTG
Bacteroidetes_CTATTCATGGAGGTCTTTCTCT	--------------------AGAGGAAGGTCCCCCACATTGGAACTGAGACACGGTCCAAACTCCTACGGGAGGCAGCAGTGAGGAATATTGGTCAATGGACGTAAGTCTGAACCAGCCAAGTAGCGTGCAGGA-TGACGG-CCCTA-TGGG-TTGTAAACTGCTTTTGTTAGGGAG-T--AAATGAA-GGCA-CGTGTGCTTTT-TTGCATTTACCTT-TCGAATAAGGACCGGCTAATTCCGTG
Bacteroidetes_CTATTCATGTTACTGTTACATT	--------------------AGAGGAAGGTCCCCCACATTGGAACTGAGACACGGTCCAAACTCCTACGGGAGGCAGCAGTGAGGAATATTGGTCAATGGACGTAAGTCTGAACCAGCCAAGTAGCGTGCAGGA-TGACGG-CCCTA-TGGG-TTGTAAACTGCTTTTATGTGAGAA-T--AAAGTTA-ACTA-CGTGTAGTTAT-TTGCATGTATCAC-ATGAATAAGGACCGGCTAATTCCGTG
Bacteroidetes_CTGCTCATGGGTGTCTCCCGTT	--------------------AGAGGAAGGTCCCCCACATTGGAACTGAGACACGGTCCAAACTCCTACGGGAGGCAGCAGTGAGGAATATTGGTCAATGGGCGTGAGCCTGAACCAGCCAAGTAGCGTGCAGGA-TGACGG-CCCTA-TGGG-TTGTAAACTGCTTTTATACGGGGA-T--AAAAGGG-TGAA-CGTGTTCTCCT-TTGCAGGTACCGT-ATGAATAAGGACCGGCTAATTCCGTG
Bacteroidetes_CTTCTCATGTGAGACTGTTATC	--------------------AGAGGAAGGTCCCCCACATTGGAACTGAGACACGGTCCAAACTCCTACGGGAGGCAGCAGTGAGGAATATTGGTCAATGGGCGTTAGCCTGAACCAGCCAAGTAGCGTGAAGGA-TGAAGG-CTCTA-TGGG-TCGTAAACTTCTTTTATATAAGAA-T--AAAGTGC-AGTATGTA-TACTGTT-TTGTATGTATTAT-ATGAATAAGGATCGGCTAACTCCGTG
Bacteroidetes_TAGCT-TTAAGGCTGCTCCGTC	--------------------AGAGGTTGAACCCCCACACTGGTACTGAGACACGGATCAGACTCCTACGGGAGGCAGCAGTGAGGAATATTGGTCAATGGGCGAGAGCCTGAACCAGCCAAGTCGCGTGAAGGA-TGACTG-TC-TTATGGA-TTGTAAACTTCTTTTATACGGGAA-T--AACAAGA-GCCA-CGTGTGGCTCC-CTGCATGTACCGT-ATGAATAAGCATCGGCTAACTCCGTG
Betaproteobacteria_ACGCCAAATCACTTTAA	AATGCCCACCAAGGCGACGATCAGTAGCGGGTCTGAGAGGACGATCCGCCACACTGGGACTGAGACACGGCCCAGACTCCTACGGGAGGCAGCAGTGGGGAATTTTGGACAATGGGGGCAACCCTGATCCAGCCATGCCGCGTGTCTGAAGAAGGCCTTCGGGTTGTAAAGGACTTTTGTTAGGGAAGAAAAGGAAAGTGTTAATACCACTTTTTGCTGACGGTACCTAAAGAATAAGCACCGGCTAACTACGTG
Betaproteobacteria_ACGCCACCTCATGTCGA	AAGGCTCACCAAGGCGACGATCGGTAGCTGGTCTGAGAGGACGACCAGCCACACTGGGACTGAGACACGGCCCAGACTCCTACGGGAGGCAGCAGTGGGGAATTTTGGACAATGGGGGCAACCCTGATCCAGCCATGCCGCGTGCAGGATGAAGGCCTTCGGGTTGTAAACTGCTTTTGTCAGGGACGAAAAGGACCGTGTTAATACCATGGTCTGCTGACGGTACCTGAAGAATAAGCACCGGCTAACTACGTG
Betaproteobacteria_ACGCCATCTCATGTCGA	AAGGCTCACCAAGGCGACGATCGGTAGCTGGTCTGAGAGGACGACCAGCCACACTGGGACTGAGACACGGCCCAGACTCCTACGGGAGGCAGCAGTGGGGAATTTTGGACAATGGGGGCAACCCTGATCCAGCCATGCCGCGTGCAGGATGAAGGCCTTCGGGTTGTAAACTGCTTTTGTCAGGGACGAAAAGGATCGTGATAATACCATGGTCTGCTGACGGTACCTGAAGAATAAGCACCGGCTAACTACGTG
Betaproteobacteria_ACGCCCTGTTAGCGCGA	AAGGCCCACCAAGGCGACGATCAGTAGCGGGTCTGAGAGGATGATCCGCCACACTGGGACTGAGACACGGCCCAGACTCCTACGGGAGGCAGCAGTGGGGAATTTTGGACAATGGGCGCAAGCCTGATCCAGCCATGCCGCGTGTCTGAAGAAGGCCTTCGGGTTGTAAAGGACTTTTGTCAGGGAAGAAAAGGCTGTTGCTAATATCAGCGGCTGATGACGGTACCTGAAGAATAAGCACCGGCTAACTACGTG
Betaproteobacteria_ACGCCGAATCACTTTAA	AAGGCCCACCAAGGCGACGATCAGTAGCGGGTCTGAGAGGATGATCCGCCACACTGGGACTGAGACACGGCCCAGACTCCTACGGGAGGCAGCAGTGGGGAATTTTGGACAATGGGGGCAACCCTGATCCAGCCATGCCGCGTGTCTGAAGAAGGCCTTCGGGTTGTAAAGGACTTTTGTTAGGGAAGAAAAGGGAAGTGCTAATACCACTTTTTGCTGACGGTACCTAAAGAATAAGCACCGGCTAACTACGTG
Betaproteobacteria_ACGCCGATCCGCATCGA	AAGGCTCACCAAGGCGACGATCGGTAGCTGGTCTGAGAGGACGACCAGCCACACTGGGACTGAGACACGGCCCAGACTCCTACGGGAGGCAGCAGTGGGGAATTTTGGACAATGGGGGCAACCCTGATCCAGCCATGCCGCGTGCAGGATGAAGGTCTTCGGATTGTAAACTGCTTTTGTCAGGGACGAAAAGGGATGCGATAACACCGCATTCCGCTGACGGTACCTGAAGAATAAGCACCGGCTAACTACGTG
Betaproteobacteria_ACGCCTCCGTCCGAGGA	AAGGCTCACCAAGGCGACGATCAATAGCTGGTCTGAGAGGACGACCAGCCACACTGGAACTGAGACACGGTCCAGACTCCTACGGGAGGCAGCAGTGGGGAATTTTGGACAATGGGGGCAACCCTGATCCAGCCATGCCGCGTGCGGGAAGAAGGCCTTCGGGTTGTAAACCGCTTTTGTCAGGGACGAAAAGCTCCGGAGTAATATGCCGGAGTGCTGACGGTACCTGAAGAATAAGCACCGGCTAACTACGTG
Betaproteobacteria_ACGCCTTCGCTGGACGA	AAGGCTCACCAAGCCGACGATCTGTAGCTGGTCTGAGAGGACGACCAGCCACACTGGGACTGAGACACGGCCCAGACTCCTACGGGAGGCAGCAGTGGGGAATTTTGGACAATGGGCGCAAGCCTGATCCAGCCATGCCGCGTGCGGGAAGAAGGCCTTCGGGTTGTAAACCGCTTTTGTCAGGGAAGAAAAGGTTCTGGCTAATACCTGGGACTCATGACGGTACCTGAAGAATAAGCACCGGCTAACTACGTG
Betaproteobacteria_ATACACATTTAGAGCAA	AAGGCCTACCAAGGCAACGATCCGTAGTGGGTCTGAGAGGATGATCCGCCACACTGGGACTGAGACACGGCCCAGACTCCTACGGGAGGCAGCAGTGGGGAATTTTGGACAATGGGCGAAAGCCTGATCCAGCCATGCCGCGTGTATGAAGAAGGCCTTAGGGTTGTAAAGTACTTTTGTTAGGGAAGAAAAGGCATTTGCTAATATCAGATGCTGATGACGGTACCTAAAGAATAAGCACCGGCTAACTACGTG
Betaproteobacteria_ATACCCTGTTGACGCGA	AAGGCCTACCAAGGCAACGATCAGTAGCGGGTCTGAGAGGATGATCCGCCACACTGGGACTGAGACACGGCCCAGACTCCTACGGGAGGCAGCAGTGGGGAATTTTGGACAATGGGCGCAAGCCTGATCCAGCCATGCCGCGTGTCTGAAGAAGGCCTTCGGGTTGTAAAGGACTTTTGTCAGGGAAGAAAAGGCTGTTGCTAATATCGACAGCTGATGACGGTACCTGAAGAATAAGCACCGGCTAACTACGTG
Betaproteobacteria_ATGCAACCTCATGTCGC	AAGGCCTACCAAGGCGACGATCTGTAGCTGGTCTGAGAGGACGACCAGCCACACTGGGACTGAGACACGGCCCAGACTCCTACGGGAGGCAGCAGTGGGGAATTTTGGACAATGGGCGAAAGCCTGATCCAGCAATGCCGCGTGTGTGATGAAGGCCTTCGGGTTGTAAAGCACTTTTGGCGGGAACGAAAAGGACCGTGCCAATACCATGGTCTGATGACGGTACCCGCAGAATAAGCACCGGCTAACTACGTG
Betaproteobacteria_ATGCAACCTCATGTTGC	AAGGCCTACCAAGGCGACGATCTGTAGCTGGTCTGAGAGGACGACCAGCCACACTGGGACTGAGACACGGCCCAGACTCCTACGGGAGGCAGCAGTGGGGAATTTTGGACAATGGGCGAAAGCCTGATCCAGCAATGCCGCGTGTGTGATGAAGGCCTTCGGGTTGTAAAGCACTTTTGGCGGGAACGAAAAGGACCGTGCTAATACCATGGTTCGATGACGGTACCCGCAGAATAAGCACCGGCTAACTACGTG
Betaproteobacteria_ATGCAACTTCACGTTGC	AAGGCCTACCAAGGCGACGATCTGTAGCTGGTCTGAGAGGACGACCAGCCACACTGGGACTGAGACACGGCCCAGACTCCTACGGGAGGCAGCAGTGGGGAATTTTGGACAATGGGCGAAAGCCTGATCCAGCAATGCCGCGTGTGTGATGAAGGCCTTCGGGTTGTAAAGCACTTTTGGCGGGAACGAAAAGGACTGTGCCAATACCACGGTTCGATGACGGTACCCGCAGAATAAGCACCGGCTAACTACGTG
Betaproteobacteria_ATGCCAAAGCCCTTCGA	AAGGCCTACCAAGGCGACGATCAGTAGCGGGTCTGAGAGGATGATCCGCCACACTGGGACTGAGACACGGCCCAGACTCCTACGGGAGGCAGCAGTGGGGAATTTTGGACAATGGGCGCAAGCCTGATCCAGCCATGCCGCGTGTCTGAAGAAGGCCTTCGGGTTGTAAAGGACTTTTGTCAGGGAAGAAAAGGAAAGGGTTAATACCCCTGTCTGATGACGGTACCTGAAGAATAAGCACCGGCTAACTACGTG
Betaproteobacteria_ATGCCACAGCCCTTCGA	AAGGCCTACCAAGGCGACGATCAGTAGCGGGTCTGAGAGGATGATCCGCCACACTGGGACTGAGACACGGCCCAGACTCCTACGGGAGGCAGCAGTGGGGAATTTTGGACAATGGGCGCAAGCCTGATCCAGCCATGCCGCGTGTCTGAAGAAGGCCTTCGGGTTGTAAAGGACTTTTGTCAGGGAAGAAAAGGACAGGGTTAATACCCCTGTCTGATGACGGTACCTGAAGAATAAGCACCGGCTAACTACGTG
Betaproteobacteria_ATGCCACAGCCCTTTGA	AAGGCCTACCAAGGCGACGATCAGTAGCGGGTCTGAGAGGATGATCCGCCACACTGGGACTGAGACACGGCCCAGACTCCTACGGGAGGCAGCAGTGGGGAATTTTGGACAATGGGCGCAAGCCTGATCCAGCCATGCCGCGTGTCTGAAGAAGGCCTTCGGGTTGTAAAGGACTTTTGTCAGGGAAGAAAAGGACAGGGTTAATACCCCTGTTTGATGACGGTACCTGAAGAATAAGCACCGGCTAACTACGTG
Betaproteobacteria_ATGCCACAGCTCTTTGA	AAGGCCTACCAAGGCGACGATCAGTAGCGGGTCTGAGAGGATGATCCGCCACACTGGGACTGAGACACGGCCCAGACTCCTACGGGAGGCAGCAGTGGGGAATTTTGGACAATGGGCGCAAGCCTGATCCAGCCATGCCGCGTGTCTGAAGAAGGCCTTCGGGTTGTAAAGGACTTTTGTCAGGGAAGAAAAGGACAGGGTTAATACCTCTGTTTGATGACGGTACCTGAAGAATAAGCACCGGCTAACTACGTG
Betaproteobacteria_ATGCCACTTCACGTTGC	AAGGCCTACCAAGGCGACGATCTGTAGCTGGTCTGAGAGGACGACCAGCCACACTGGGACTGAGACACGGCCCAGACTCCTACGGGAGGCAGCAGTGGGGAATTTTGGACAATGGGCGCAAGCCTGATCCAGCAATGCCGCGTGTGTGATGAAGGCCTTCGGGTTGTAAAGCACTTTTGGCGGGAACGAAAAGGACTGTGCCAATACCACGGTTCGATGACGGTACCCGCAGAATAAGCACCGGCTAACTACGTG
Betaproteobacteria_ATGCCACTTCATGTTGC	AAGGCCTACCAAGGCGACGATCTGTAGCTGGTCTGAGAGGACGACCAGCCACACTGGGACTGAGACACGGCCCAGACTCCTACGGGAGGCAGCAGTGGGGAATTTTGGACAATGGGCGCAAGCCTGATCCAGCAATGCCGCGTGTGTGATGAAGGCCTTCGGGTTGTAAAGCACTTTTGGCGGGAACGAAAAGGACTGTGCCAATACCATGGTTCGATGACGGTACCCGCAGAATAAGCACCGGCTAACTACGTG
Betaproteobacteria_ATGCCAGTGCCGATCGA	AAGGCCTACCAAGGCGACGATCAGTAGCGGGTCTGAGAGGACGATCCGCCACACTGGGACTGAGACACGGCCCAGACTCCTACGGGAGGCAGCAGTGGGGAATTTTGGACAATGGGCGCAAGCCTGATCCAGCCATGCCGCGTGTCTGAAGAAGGCCTTCGGGTTGTAAAGGACTTTTGTCAGGGAAGAAAAGGAGTTGGTTAATACCCGACTCTGATGACGGTACCTGAAGAATAAGCACCGGCTAACTACGTG
Betaproteobacteria_ATGCCATAGCCCTTCGA	AAGGCCTACCAAGGCGACGATCAGTAGCGGGTCTGAGAGGATGATCCGCCACACTGGGACTGAGACACGGCCCAGACTCCTACGGGAGGCAGCAGTGGGGAATTTTGGACAATGGGCGCAAGCCTGATCCAGCCATGCCGCGTGTCTGAAGAAGGCCTTCGGGTTGTAAAGGACTTTTGTCAGGGAAGAAAAGGATAGGGTTAATACCCCTGTCTGATGACGGTACCTGAAGAATAAGCACCGGCTAACTACGTG
Betaproteobacteria_ATGCCATATCATTTCAA	AAGGCCTACCAAGGCGACGATCAGTAGCGGGTCTGAGAGGATGATCCGCCACACTGGGACTGAGACACGGCCCAGACTCCTACGGGAGGCAGCAGTGGGGAATTTTGGACAATGGGCGCAAGCCTGATCCAGCCATGCCGCGTGTCTGAAGAAGGCCTTCGGGTTGTAAAGGACTTTTGTTAGGGAAGAAAAGGATAGTGTTAATACCATTATCTGCTGACGGTACCTAAAGAATAAGCACCGGCTAACTACGTG
Betaproteobacteria_ATGCCCTGCCGACGCGA	AAGGCCTACCAAGGCGACGATCAGTAGCGGGTCTGAGAGGATGATCCGCCACACTGGGACTGAGACACGGCCCAGACTCCTACGGGAGGCAGCAGTGGGGAATTTTGGACAATGGGCGCAAGCCTGATCCAGCCATGCCGCGTGTCTGAAGAAGGCCTTCGGGTTGTAAAGGACTTTTGTCAGGGAAGAAAAGGCTGTCGCTAATACCGACAGCTGATGACGGTACCTGAAGAATAAGCACCGGCTAACTACGTG
Betaproteobacteria_ATGCCCTGCCGACGTGA	AAGGCCTACCAAGGCGACGATCAGTAGCGGGTCTGAGAGGATGATCCGCCACACTGGGACTGAGACACGGCCCAGACTCCTACGGGAGGCAGCAGTGGGGAATTTTGGACAATGGGCGCAAGCCTGATCCAGCCATGCCGCGTGTCTGAAGAAGGCCTTCGGGTTGTAAAGGACTTTTGTCAGGGAAGAAAAGGCTGTCGCTAATACCGACAGTTGATGACGGTACCTGAAGAATAAGCACCGGCTAACTACGTG
Betaproteobacteria_ATGCCCTGTCGACGCGA	AAGGCCTACCAAGGCGACGATCAGTAGCGGGTCTGAGAGGATGATCCGCCACACTGGGACTGAGACACGGCCCAGACTCCTACGGGAGGCAGCAGTGGGGAATTTTGGACAATGGGCGCAAGCCTGATCCAGCCATGCCGCGTGTCTGAAGAAGGCCTTCGGGTTGTAAAGGACTTTTGTCAGGGAAGAAAAGGCTGTTGCTAATACCGACAGCTGATGACGGTACCTGAAGAATAAGCACCGGCTAACTACGTG
Betaproteobacteria_ATGCCCTGTCGACGTGA	AAGGCCTACCAAGGCGACGATCAGTAGCGGGTCTGAGAGGATGATCCGCCACACTGGGACTGAGACACGGCCCAGACTCCTACGGGAGGCAGCAGTGGGGAATTTTGGACAATGGGCGCAAGCCTGATCCAGCCATGCCGCGTGTCTGAAGAAGGCCTTCGGGTTGTAAAGGACTTTTGTCAGGGAAGAAAAGGCTGTTGCTAATACCGACAGTTGATGACGGTACCTGAAGAATAAGCACCGGCTAACTACGTG
Betaproteobacteria_ATGCCCTGTTAATGCGA	AAGGCCTACCAAGGCGACGATCAGTAGCGGGTCTGAGAGGATGATCCGCCACACTGGGACTGAGACACGGCCCAGACTCCTACGGGAGGCAGCAGTGGGGAATTTTGGACAATGGGCGCAAGCCTGATCCAGCCATGCCGCGTGTCTGAAGAAGGCCTTCGGGTTGTAAAGGACTTTTGTCAGGGAAGAAAAGGCTGTTGCTAATATCAATAGCTGATGACGGTACCTGAAGAATAAGCACCGGCTAACTACGTG
Betaproteobacteria_ATGCCCTGTTAGCGCGA	AAGGCCTACCAAGGCGACGATCAGTAGCGGGTCTGAGAGGATGATCCGCCACACTGGGACTGAGACACGGCCCAGACTCCTACGGGAGGCAGCAGTGGGGAATTTTGGACAATGGGCGCAAGCCTGATCCAGCCATGCCGCGTGTCTGAAGAAGGCCTTCGGGTTGTAAAGGACTTTTGTCAGGGAAGAAAAGGCTGTTGCTAATATCAGCGGCTGATGACGGTACCTGAAGAATAAGCACCGGCTAACTACGTG
Betaproteobacteria_ATGCCCTGTTGACGCGA	AAGGCCTACCAAGGCGACGATCAGTAGCGGGTCTGAGAGGATGATCCGCCACACTGGGACTGAGACACGGCCCAGACTCCTACGGGAGGCAGCAGTGGGGAATTTTGGACAATGGGCGCAAGCCTGATCCAGCCATGCCGCGTGTCTGAAGAAGGCCTTCGGGTTGTAAAGGACTTTTGTCAGGGAAGAAAAGGCTGTTGCTAATATCGACAGCTGATGACGGTACCTGAAGAATAAGCACCGGCTAACTACGTG
Betaproteobacteria_ATGCCGAATCACTTTAA	AAGGCCTACCAAGGCGACGATCAGTAGCGGGTCTGAGAGGACGATCCGCCACACTGGGACTGAGACACGGCCCAGACTCCTACGGGAGGCAGCAGTGGGGAATTTTGGACAATGGGGGCAACCCTGATCCAGCCATGCCGCGTGTATGAAGAAGGCCTTCGGGTTGTAAAGTACTTTTGTTAGGGAAGAAAAGGGAAGTGCTAATACCACTTTTTGCTGACGGTACCTAAAGAATAAGCACCGGCTAACTACGTG
Betaproteobacteria_ATGCCGAGGCCGTTCAA	AAGGCCTACCAAGGCGACGATCAGTAGCGGGTCTGAGAGGATGATCCGCCACACTGGGACTGAGACACGGCCCAGACTCCTACGGGAGGCAGCAGTGGGGAATTTTGGACAATGGGCGCAAGCCTGATCCAGCCATGCCGCGTGTCTGAAGAAGGCCTTCGGGTTGTAAAGGACTTTTGTTAGGGAAGAAAAAGGAGCGGTTAATACCCGTTTCTGCTGACGGTACCTAAAGAATAAGCACCGGCTAACTACGTG
Betaproteobacteria_ATGCCGCGGCCCTTCGA	AAGGCCTACCAAGGCGACGATCAGTAGCGGGTCTGAGAGGATGATCCGCCACACTGGGACTGAGACACGGCCCAGACTCCTACGGGAGGCAGCAGTGGGGAATTTTGGACAATGGGCGCAAGCCTGATCCAGCCATGCCGCGTGTCTGAAGAAGGCCTTCGGGTTGTAAAGGACTTTTGTCAGGGAAGAAAAGGGCGGGGTTAATACCCCTGTCTGATGACGGTACCTGAAGAATAAGCACCGGCTAACTACGTG
Betaproteobacteria_ATGCCGCGTCATTCGGA	AAGGCCTACCAAGGCGACGATCAGTAGCGGGTCTGAGAGGATGATCCGCCACACTGGGACTGAGACACGGCCCAGACTCCTACGGGAGGCAGCAGTGGGGAATTTTGGACAATGGGGGCAACCCTGATCCAGCCATGCCGCGTGTCTGAAGAAGGCCTTCGGGTTGTAAAGGACTTTTGTCCGGGAAGAAAAGCGCGATGTTAATACCATTGCGTGCTGACGGTACCGGAAGAATAAGCACCGGCTAACTACGTG
Betaproteobacteria_ATGCCGGAGCCGTTCAA	AAGGCCTACCAAGGCGACGATCAGTAGCGGGTCTGAGAGGATGATCCGCCACACTGGGACTGAGACACGGCCCAGACTCCTACGGGAGGCAGCAGTGGGGAATTTTGGACAATGGGCGCAAGCCTGATCCAGCCATGCCGCGTGTCTGAAGAAGGCCTTCGGGTTGTAAAGGACTTTTGTTGGGGAAGAAAAGGGGACGGTTAATACCCGTTTCTGCTGACGGTACCCAAAGAATAAGCACCGGCTAACTACGTG
Betaproteobacteria_ATGCCTTGTTGACGCGA	AAGGCCTACCAAGGCGACGATCAGTAGCGGGTCTGAGAGGATGATCCGCCACACTGGGACTGAGACACGGCCCAGACTCCTACGGGAGGCAGCAGTGGGGAATTTTGGACAATGGGCGCAAGCCTGATCCAGCCATGCCGCGTGTCTGAAGAAGGCCTTCGGGTTGTAAAGGACTTTTGTCAGGGAAGAAAAGGTTGTTGCTAATATCGACAGCTGATGACGGTACCTGAAGAATAAGCACCGGCTAACTACGTG
Betaproteobacteria_ATGCGCATTTAGAGCAA	AAGGCCTACCAAGGCGACGATCCGTAGCGGGTCTGAGAGGATGATCCGCCACACTGGGACTGAGACACGGCCCAGACTCCTACGGGAGGCAGCAGTGGGGAATTTTGGACAATGGGGGGAACCCTGATCCAGCCATGCCGCGTGTATGAAGAAGGCCTTAGGGTTGTAAAGTACTTTTGTTAGGGAAGAAAAGGCATTTGCTAATATCAGATGCTGATGACGGTACCTAAAGAATAAGCACCGGCTAACTACGTG
Betaproteobacteria_ATGTAACTTCACGTTGC	AAGGCCTACCAAGGCGACGATCTGTAGCTGGTCTGAGAGGACGACCAGTCACACTGGGACTGAGACACGGCCCAGACTCCTACGGGAGGCAGCAGTGGGGAATTTTGGACAATGGGCGAAAGCCTGATCCAGCAATGCCGCGTGTGTGATGAAGGCCTTCGGGTTGTAAAGCACTTTTGGCGGGAACGAAAAGGACTGTGCCAATACCACGGTTCGATGACGGTACCCGCAGAATAAGCACCGGCTAACTACGTG
Betaproteobacteria_ATTCCGCCGTTGGTCTA	AAGGCTTACCAAGCCTGCGATCTGTAGCTGGTCTGAGAGGATGATCAGCCACACTGGGACTGAGACACGGCCCAGACTCCTACGGGAGGCAGCAGTGGGGAATTTTGGACAATGGGCGCAAGCCTGATCCAGCCATTCCGCGTGCAGGATGAAGGCCCTCGGGTTGTAAACTGCTTTTGTACAGAACGAAAAAGGCCTGGCTAATATCTGGGTCTCATGACGGTACTGTAAGAATAAGCACCGGCTAACTACGTG
Betaproteobacteria_CCACCCACAATGGGTTA	ACGGCTCACCAAAGCAACGATCAGTAGCTGGTCTGAGAGGACGACCAGCCACACTGGGACTGAGACACGGCCCAGACTCCTACGGGAGGCAGCAGTGGGGAATTTTGGACAATGGGCGCAAGCCTGATCCAGCTATTCCGCGTGTGGGATGAAGGCCCTCGGGTTGTAAACCACTTTTGTAGAGAACGAAAAGACACCATCGAATAAATGGTGTTGCTGACGGTACTCTAAGAATAAGCACCGGCTAACTACGTG
Betaproteobacteria_CCACCCACTAGGGGTTA	ACGGCTCACCAAAGCAACGATCAGTAGCTGGTCTGAGAGGACGACCAGCCACACTGGGACTGAGACACGGCCCAGACTCCTACGGGAGGCAGCAGTGGGGAATTTTGGACAATGGGCGCAAGCCTGATCCAGCTATTCCGCGTGTGGGATGAAGGCCCTCGGGTTGTAAACCACTTTTGTAGAGAACGAAAAGACACCTTCGAATAAAGGGTGTTGCTGACGGTACTCTAAGAATAAGCACCGGCTAACTACGTG
Betaproteobacteria_CCACCCATTAGGAGTTA	ACGGCTCACCAAAGCAACGATCAGTAGCTGGTCTGAGAGGACGACCAGCCACACTGGGACTGAGACACGGCCCAGACTCCTACGGGAGGCAGCAGTGGGGAATTTTGGACAATGGGCGCAAGCCTGATCCAGCTATTCCGCGTGTGGGATGAAGGCCCTCGGGTTGTAAACCACTTTTGTAGAGAACGAAAAGACATCTTCGAATAAAGGATGTTGCTGACGGTACTCTAAGAATAAGCACCGGCTAACTACGTG
Betaproteobacteria_GTGCATTGTTATTACAA	AGAGCCTACCAAGCCGACGATCAGTAGTGGGTCTTAGAGGATGATCCGCCACACTGGGACTGAGACACGGCCCAGACTCCTACGGGAGGCAGCAGTGGGGAATTTTGGACAATGGGCGAAAGCCTGATCCAGCCATGCCGCGTGTCTGAAGAAGGCCTTCGGGTTGTAAAGGACTTTTGTTAGGGAAGAAAAGGTTGATGCTAATATCATTAACTGATGACGGTACCTAAAGAATAAGCACCGGCTAACTACGTG
Betaproteobacteria_GTGCCATATCATTTCAA	AGGGCCTACCAAGGCGACGATCAGTAGCGGGTCTGAGAGGATGATCCGCCACACTGGGACTGAGACACGGCCCAGACTCCTACGGGAGGCAGCAGTGGGGAATTTTGGACAATGGGCGCAAGCCTGATCCAGCCATGCCGCGTGTCTGAAGAAGGCCTTCGGGTTGTAAAGGACTTTTGTTAGGGAAGAAAAGGATAGTGTTAATACCATTATCTGCTGACGGTACCTAAAGAATAAGCACCGGCTAACTACGTG
Betaproteobacteria_GTGCCGAATTACTTTAA	AGGGCTTACCAAGGCGATGATCAGTAGCGGGTCTGAGAGGATGATCCGCCACACTGGGACTGAGAGACGGCCCAGACTCCTACGGGAGGCAGCAGTGGGGAATTTTGGACAATGGGGGCAACCCTGATCCAGCCATGCCGCGTGTCTGAAGAAGGCCTTCGGGTTGTAAAGGACTTTTGTTAGGGAAGAAAAGGGAAGTGCTAATATCACTTTTTGCTGACGGTACCTAAAGAATAAGCACCGGCTAACTACGTG
Betaproteobacteria_GTGCCGAGGCCGTTCAA	AGGGCCTACCAAGGCGACGATCAGTAGCGGGTCTGAGAGGATGATCCGCCACACTGGGACTGAGACACGGCCCAGACTCCTACGGGAGGCAGCAGTGGGGAATTTTGGACAATGGGCGCAAGCCTGATCCAGCCATGCCGCGTGTCTGAAGAAGGCCTTCGGGTTGTAAAGGACTTTTGTTAGGGAAGAAAAAGGAGCGGTTAATACCCGTTTCTGCTGACGGTACCTAAAGAATAAGCACCGGCTAACTACGTG
Epsilonproteobacteria_ATCAACACCCATTC	TGAGACTATATCGTATCAGCTAGTTGGTGAAGTAATGGCTCACCAAGGCTATGACGCGTAACTGGTCTGAGAGGATGATCAGTCACATTGGAACTGAGACACGGTCCAAACTCCTACGGGAGGCAGCAGTAGGGAATATTGCGCAATGGGGGAAACCCTGACGCAGCAACGCCGCGTGGAGGATGACACTTTTCGGAGCGTAAACTCCTTTTGTTAGGGAAGAATAATGACGGTACCTAACGAATAAGCACCGGCTAACTCCGTG
Epsilonproteobacteria_GCTAACGCACGTTG	TAGGGCTATATCGTATCAGCTAGTTGGTAAGGTAACGGCTTACCAAGGCTATGACGCGTAACTGGTCTGAGAGGATGATCAGTCACACTGGAACTGAGACACGGTCCAGACTCCTACGGGAGGCAGCAGTAGGGAATATTGCTCAATGGGGGAAACCCTGAAGCAGCAACGCCGCGTGGAGGATGACACTTTTCGGAGCGTAAACTCCTTTTCTTGGGAAAGAATTATGACGGTACCCAAGGAATAAGCACCGGCTAACTCCGTG
Epsilonproteobacteria_GCTAACGTACGTTG	TAGGGCTATATCGTATCAGCTAGTTGGTAAGGTAACGGCTTACCAAGGCTATGACGCGTAACTGGTCTGAGAGGATGATCAGTCACACTGGAACTGAGACACGGTCCAGACTCCTACGGGAGGCAGCAGTAGGGAATATTGCTCAATGGGGGAAACCTTGAAGCAGCAACGCCGCGTGGAGGATGACACTTTTCGGAGCGTAAACTCCTTTTCTTGGGAAAGAATTATGACGGTACCCAAGGAATAAGCACCGGCTAACTCCGTG
Epsilonproteobacteria_GCTGACACCCATTC	TGAGACTATATCGTATCAGCTAGTCGGTGGGGTAACGGCCTACCGAGGCTATGACGCGTAACTGGTCTGAGAGGATGATCAGTCACATTGGAACTGAGACACGGTCCAAACTCCTACGGGAGGCAGCAGTAGGGAATATTGCGCAATGGGGGAAACCCTGACGCAGCAACGCCGCGTGGAGGATGACACTTTTCGGAGCGTAAACTCCTTTTGTTAGGGAAGAATAATGACGGTACCTAACGAATAAGCACCGGCTAACTCCGTG
Epsilonproteobacteria_GTCAACACACGTTC	TGAGACTATATCGTATCAGCTAGTTGGTGAGGTAATGGCTCACCAAGGCTATGACGCGTAACTGGTCTGAGAGGATGATCAGTCACATTGGAACTGAGACACGGTCCAAACTCCTACGGGAGGCAGCAGTAGGGAATATTGCTCAATGGGGGAAACCCTGAAGCAGCAACGCCGCGTGGAGGATGACACTTTTCGGAGCGTAAACTCCTTTTGTTGGGGAAGAATAATGACGGTACCTAACGAATAAGCACCGGCTAACTCCGTG
Epsilonproteobacteria_GTCAACACCCATTC	TGAGACTATATCGTATCAGCTAGTTGGTGAGGTAATGGCTCACCAAGGCTATGACGCGTAACTGGTCTGAGAGGATGATCAGTCACATTGGAACTGAGACACGGTCCAAACTCCTACGGGAGGCAGCAGTAGGGAATATTGCGCAATGGGGGAAACCCTGACGCAGCAACGCCGCGTGGAGGATGACACTTTTCGGAGCGTAAACTCCTTTTGTTAGGGAAGAATAATGACGGTACCTAACGAATAAGCACCGGCTAACTCCGTG
Epsilonproteobacteria_GTCAACGCACACCC	TGAGGCTATATTGTATCAGCTAGTTGGTGAGGTAATGGCTCACCAAGGCTATGACGCATAACTGGTCTGAGAGGATGATCAGTCACACTGGAACTGAGACACGGTCCAGACTCCTACGGGAGGCAGCAGTAGGGAATATTGCTCAATGGGGGAAACCCTGAAGCAGCAACGCCGCGTGGAGGATGACACTTTTCGGAGCGTAAACTCCTTTTGTTAGGGAAGAACAACGACGGTACCTAACGAATAAGCACCGGCTAACTCCGTG
Epsilonproteobacteria_GTCAACGCACACTC	TGAGGCTATATTGTATCAGCTAGTTGGTGAGGTAATGGCTCACCAAGGCTATGACGCATAACTGGTCTGAGAGGATGATCAGTCACACTGGAACTGAGACACGGTCCAGACTCCTACGGGAGGCAGCAGTAGGGAATATTGCTCAATGGGGGAAACCCTGAAGCAGCAACGCCGCGTGGAGGATGACACTTTTCGGAGCGTAAACTCCTTTTGTTAGGGAAGAACAATGACGGTACCTAACGAATAAGCACCGGCTAACTCCGTG
Epsilonproteobacteria_GTCAACGCACATTC	TGAGGCTATATTGTATCAGCTAGTTGGTGAGGTAATGGCTCACCAAGGCTATGACGCATAACTGGTCTGAGAGGATGATCAGTCACACTGGAACTGAGACACGGTCCAGACTCCTACGGGAGGCAGCAGTAGGGAATATTGCTCAATGGGGGAAACCCTGAAGCAGCAACGCCGCGTGGAGGATGACACTTTTCGGAGCGTAAACTCCTTTTGTTAGGGAAGAATAATGACGGTACCTAACGAATAAGCACCGGCTAACTCCGTG
Epsilonproteobacteria_GTCAACGCACGTTC	TGAGGCTATATTGTATCAGCTAGTTGGTGAGGTAATGGCTCACCAAGGCTATGACGCATAACTGGTCTGAGAGGATGATCAGTCACACTGGAACTGAGACACGGTCCAGACTCCTACGGGAGGCAGCAGTAGGGAATATTGCTCAATGGGGGAAACCCTGAAGCAGCAACGCCGCGTGGAGGATGACACTTTTCGGAGCGTAAACTCCTTTTGTTGGGGAAGAATAATGACGGTACCTAACGAATAAGCACCGGCTAACTCCGTG
Epsilonproteobacteria_GTCAACGCACGTTG	TGAGGCTATATCGTATCAGCTAGTTGGTGAGGTAATGGCTCACCAAGGCTATGACGCGTAACTGGTCTGAGAGGATGATCAGTCACACTGGAACTGAGACACGGTCCAGACTCCTACGGGAGGCAGCAGTAGGGAATATTGCTCAATGGGGGAAACCCTGAAGCAGCAACGCCGCGTGGAGGATGACACTTTTCGGAGCGTAAACTCCTTTTCTTGGGAAAGAATTATGACGGTACCCAAGGAATAAGCACCGGCTAACTCCGTG
Epsilonproteobacteria_GTCAACGCATACTC	TGAGGCTATATTGTATCAGCTAGTTGGTGAGGTAATGGCTCACCAAGGCTATGACGCATAACTGGTCTGAGAGGATGATCAGTCACACTGGAACTGAGACACGGTCCAGACTCCTACGGGAGGCAGCAGTAGGGAATATTGCTCAATGGGGGAAACCCTGAAGCAGCAACGTCGCGTGGAGGATGACACTTTTCGGAGCGTAAACTCCTTTTGTTAGGGAAGAACAATGACGGTACCTAACGAATAAGCACCGGCTAACTCCGTG
Epsilonproteobacteria_GTCAACGCGCACTC	TGAGGCTATATTGTATCAGCTAGTTGGTGAGGTAATGGCTCACCAAGGCTATGACGCATAACTGGTCTGAGAGGATGATCAGTCACACTGGAACTGAGACACGGTCCAGACTCCTACGGGAGGCAGCAGTAGGGAATATTGCTCAATGGGGGAAACCCTGAGGCAGCAACGCCGCGTGGAGGATGACACTTTTCGGAGCGTAAACTCCTTTTGTTAGGGAAGAACAATGACGGTACCTAACGAATAAGCACCGGCTAACTCCGTG
Epsilonproteobacteria_GTCAACGTACACTC	TGAGGCTATATTGTATCAGCTAGTTGGTGAGGTAATGGCTCACCAAGGCTATGACGCATAACTGGTCTGAGAGGATGATCAGTCACACTGGAACTGAGACACGGTCCAGACTCCTACGGGAGGCAGCAGTAGGGAATATTGCTCAATGGGGGAAACCTTGAAGCAGCAACGCCGCGTGGAGGATGACACTTTTCGGAGCGTAAACTCCTTTTGTTAGGGAAGAACAATGACGGTACCTAACGAATAAGCACCGGCTAACTCCGTG
Epsilonproteobacteria_GTTAACACCCATTC	TGAGACTATATCGTATCAGCTAGTTGGTAAGGTAATGGCTTACCAAGGCTATGACGCGTAACTGGTCTGAGAGGATGATCAGTCACATTGGAACTGAGACACGGTCCAAACTCCTACGGGAGGCAGCAGTAGGGAATATTGCGCAATGGGGGAAACCCTGACGCAGCAACGCCGCGTGGAGGATGACACTTTTCGGAGCGTAAACTCCTTTTGTTAGGGAAGAATAATGACGGTACCTAACGAATAAGCACCGGCTAACTCCGTG
Epsilonproteobacteria_GTTAACGCACACTC	TGAGGCTATATTGTATCAGCTAGTTGGTGAGGTAATGGCTTACCAAGGCTATGACGCATAACTGGTCTGAGAGGATGATCAGTCACACTGGAACTGAGACACGGTCCAGACTCCTACGGGAGGCAGCAGTAGGGAATATTGCTCAATGGGGGAAACCCTGAAGCAGCAACGCCGCGTGGAGGATGACACTTTTCGGAGCGTAAACTCCTTTTGTTAGGGAAGAACAATGACGGTACCTAACGAATAAGCACCGGCTAACTCCGTG
Epsilonproteobacteria_GTTAACGCACGTTG	TAGGGCTATATCGTATCAGCTAGTTGGTAAGGTAATGGCTTACCAAGGCTATGACGCGTAACTGGTCTGAGAGGATGATCAGTCACACTGGAACTGAGACACGGTCCAGACTCCTACGGGAGGCAGCAGTAGGGAATATTGCTCAATGGGGGAAACCCTGAAGCAGCAACGCCGCGTGGAGGATGACACTTTTCGGAGCGTAAACTCCTTTTCTTGGGAAAGAATTATGACGGTACCCAAGGAATAAGCACCGGCTAACTCCGTG
Epsilonproteobacteria_GTTGACACCCATTC	TGAGACTATATCGTATCAGCTAGTCGGTGGGGTAATGGCCTACCGAGGCTATGACGCGTAACTGGTCTGAGAGGATGATCAGTCACATTGGAACTGAGACACGGTCCAAACTCCTACGGGAGGCAGCAGTAGGGAATATTGCGCAATGGGGGAAACCCTGACGCAGCAACGCCGCGTGGAGGATGACACTTTTCGGAGCGTAAACTCCTTTTGTTAGGGAAGAATAATGACGGTACCTAACGAATAAGCACCGGCTAACTCCGTG
Firmicutes_-ACCAAAATCGAGGTTCTGTTTAGAAGACGAC-	----------------------------AAGGCCCACCAAGGCAATGATCAGTAGCCGGTCTGAGAGGATGAACGGCCACATTGGGACTGAGACACGGCCCAGACTCCTACGGGAGGCAGCAGTGGGGAATCTTCCGCAATGGACGAAAGTCTGACGGAGCAACGCCGCGTGAGTGATGACGGCC-TT-CGGG-TTGTAAAGCTCTGTTAATCGG-GACGAAAGGTC--TTCTTG--C-G-AATAGTTAGAA-GAA-TTGACGGTACCGGAA-TAGAAAGCCACGGCTAACTACGTG
Firmicutes_-ACCAGTACTGT-GTATTTCTACATATACACC-	---------------------------AAAGGCCCACCAAGGCGACGATGCATAGCCGACCTGAGAGGGTGATCGGCCACACTGGGACTGAGACACGGCCCAGACTCCTACGGGAGGCAGCAGTAGGGAATCTTCCGCAATGGGCGAAAGCCTGACGGAGCAACGCCGCGTGAGTGAAGAAGGAT-TT-CGGT-TCGTAAAGCTCTGTTGTTAGG-GAAGAAT-GGA--TATGTA--G-T-AACTATACATA-TAA-GAGACGGTACCTAAC-CAGAAAGCCACGGCTAACTACGTG
Firmicutes_-ACCAGTACTGT-GTATTTCTACATGTACACC-	---------------------------AAAGGCCCACCAAGGCGACGATGCATAGCCGACCTGAGAGGGTGATCGGCCACACTGGGACTGAGACACGGCCCAGACTCCTACGGGAGGCAGCAGTAGGGAATCTTCCGCAATGGGCGAAAGCCTGACGGAGCAACGCCGCGTGAGTGAAGAAGGAT-TT-CGGT-TCGTAAAGCTCTGTTGTTAGG-GAAGAAT-GGA--TATGTA--G-T-AACTATACATG-TAA-GAGACGGTACCTAAC-CAGAAAGCCACGGCTAACTACGTG
Firmicutes_-ACCAGTACTGTGGATGAATATACATTACACC-	---------------------------AAAGGCCCACCAAGGCGACGATGCATAGCCGACCTGAGAGGGTGATCGGCCACACTGGGACTGAGACACGGCCCAGACTCCTACGGGAGGCAGCAGTAGGGAATCTTCCGCAATGGGCGAAAGCCTGACGGAGCAACGCCGCGTGAGTGAAGAAGGAT-TT-CGGT-TCGTAAAGCTCTGTTGTTAGG-GAAGAATGGAT--ATGTAG--T-A-ACT--ATACATGTAC-GAGACGGTACCTAAC-CAGAAAGCCACGGCTAACTACGTG
Firmicutes_-ACTAGAACTGT-GTGTTTCTACACAGTCACC-	---------------------------AAAGGCCTACCAAGGCGACGATGCATAGCCGACCTGAGAGGGTGAACGGCCACACTGGGACTGAGACACGGCCCAGACTCCTACGGGAGGCAGCAGTAGGGAATCTTCCGCAATGGGCGAAAGCCTGACGGAGCAACGCCGCGTGAGTGAAGAAGGAT-TT-CGGT-TCGTAAAGCTCTGTTGTTAGG-GAAGAAT-GAT--TGTGTA--G-T-AACTATACACA-GTA-GAGACGGTACCTAAC-CAGAAAGCCACGGCTAACTACGTG
Firmicutes_-ACTAGTACTGT-GTATTTCTACATAGTCACC-	---------------------------AAAGGCCTACCAAGGCGACGATGCATAGCCGACCTGAGAGGGTGATCGGCCACACTGGGACTGAGACACGGCCCAGACTCCTACGGGAGGCAGCAGTAGGGAATCTTCCGCAATGGGCGAAAGCCTGACGGAGCAACGCCGCGTGAGTGAAGAAGGAT-TT-CGGT-TCGTAAAGCTCTGTTGTTAGG-GAAGAAT-GAT--TATGTA--G-T-AACTATACATA-GTA-GAGACGGTACCTAAC-CAGAAAGCCACGGCTAACTACGTG
Firmicutes_-ACTAGTACTGT-GTGTTTCTACACAGTCACC-	---------------------------AAAGGCCTACCAAGGCGACGATGCATAGCCGACCTGAGAGGGTGATCGGCCACACTGGGACTGAGACACGGCCCAGACTCCTACGGGAGGCAGCAGTAGGGAATCTTCCGCAATGGGCGAAAGCCTGACGGAGCAACGCCGCGTGAGTGAAGAAGGAT-TT-CGGT-TCGTAAAGCTCTGTTGTTAGG-GAAGAAT-GAT--TGTGTA--G-T-AACTATACACA-GTA-GAGACGGTACCTAAC-CAGAAAGCCACGGCTAACTACGTG
Firmicutes_-ACTAGTACTGT-GTGTTTCTACATAGTCACC-	---------------------------AAAGGCCTACCAAGGCGACGATGCATAGCCGACCTGAGAGGGTGATCGGCCACACTGGGACTGAGACACGGCCCAGACTCCTACGGGAGGCAGCAGTAGGGAATCTTCCGCAATGGGCGAAAGCCTGACGGAGCAACGCCGCGTGAGTGAAGAAGGAT-TT-CGGT-TCGTAAAGCTCTGTTGTTAGG-GAAGAAT-GAT--TGTGTA--G-T-AACTATACATA-GTA-GAGACGGTACCTAAC-CAGAAAGCCACGGCTAACTACGTG
Firmicutes_-ACTAGTACTGT-GTGTTTCTATACAGTCACC-	---------------------------AAAGGCCTACCAAGGCGACGATGCATAGCCGACCTGAGAGGGTGATCGGCCACACTGGGACTGAGACACGGCCCAGACTCCTACGGGAGGCAGCAGTAGGGAATCTTCCGCAATGGGCGAAAGCCTGACGGAGCAACGCCGCGTGAGTGAAGAAGGAT-TT-CGGT-TCGTAAAGCTCTGTTGTTAGG-GAAGAAT-GAT--TGTATA--G-T-AACTATATACA-GTA-GAGACGGTACCTAAC-CAGAAAGCCACGGCTAACTACGTG
Firmicutes_-ACTAGTCTCGCAGCATGTCGCTATGCGTACC-	---------------------------AAAGGCCTACCAAGGCGATGATGCATAGCCGACCTGAGAGGGTGATCGGCCACATTGGGACTGAGACACGGCCCAAACTCCTACGGGAGGCAGCAGTAGGGAATCTTCCGCAATGGACGCAAGTCTGACGGAGCAACGCCGCGTGAGTGAAGAAGGTC-TT-CGGA-TCGTAAAGCTCTGTTGTTAGA-GAAGAACAGCG--CATAGA--G-T-AAC-TGCTATG-CGT-GTGACGGTATCTAAC-CAGAAAGCCACGGCTAACTACGTG
Firmicutes_-ACTAGTCTCGCAGCATGTCGTTATGCGTACC-	---------------------------AAAGGCCTACCAAGGCGATGATGCATAGCCGACCTGAGAGGGTGATCGGCCACATTGGGACTGAGACACGGCCCAAACTCCTACGGGAGGCAGCAGTAGGGAATCTTCCGCAATGGACGCAAGTCTGACGGAGCAACGCCGCGTGAGTGAAGAAGGTC-TT-CGGA-TCGTAAAGCTCTGTTGTTAGA-GAAGAACAGCG--CATAGA--G-T-AAC-TGTTATG-CGT-GTGACGGTATCTAAC-CAGAAAGCCACGGCTAACTACGTG
Firmicutes_-ACTAGTGTTGCGAGTGGTAGTTCACACTTCG-	----------------------------AAGGCCTACCAAGGCGACGATGCATAGCCGACCTGAGAGGGTGATCGGCCACACTGGGACTGAGACACGGCCCAGACTCCTACGGGAGGCAGCAGTAGGGAATCTTCGGCAATGGACGGAAGTCTGACCGAGCAACGCCGCGTGAGTGAAGAAGGTT-TT-CGGA-TCGTAAAGCTCTGTTGTAAGA-GAAGAACGAGT--GTGAGA--G-T-GGAAAGTTCAC-ACT-GTGACGGTATCTTAC-CAGAAAGGGACGGCTAACTACGTG
Firmicutes_-ATCAGAACCGAGAGTTTTCGACAATACGGGC-	---------------------------AAAGGCTCACCAAGGCGACGATCAGTAGCCGGCCTGAGAGGGTGAACGGCCACATTGGGACTGAGACACGGCCCAAACTCCTACGGGAGGCAGCAGTGGGGAATCTTCCGCAATGGGCGAAAGCCTGACGGAGCAATGCCGCGTGAGTGAAGAAGGCC-TT-CGGG-TTGTAAAACTCTGTCCTTATC-GAAGAGAGAGT--GTTGTA--G-T-AAC-TGACAAT-ACT-AGGACGGTAGATGAG-GAGGAAGCCCCGGCTAACTATGTG
Firmicutes_-CCCAAAATCGAGATCTCGTTGCAGAAACGAC-	----------------------------ACGGCCCACCAAGGCAATGATCAGTAGCCGGTCTGAGAGGATGAACGGCCACATTGGGACTGAGACACGGCCCAAACTCCTACGGGAGGCAGCAGTGGGGAATCTTCCGCAATGGACGAAAGTCTGACGGAGCAACGCCGCGTGAGTGATGAAGGTC-TT-CGGA-TTGTAAAGCTCTGTTAATCGG-GACGAAAGAGT--TCTGCG--T-G-AATAATGCAGA-AAA-GTGACGGTACCGGAA-TAGAAAGCCACGGCTAACTACGTG
Firmicutes_-CCCAAAATCGAGATCTTATTGCAGAAACGAC-	----------------------------ACGGCCCACCAAGGCAATGATCAGTAGCCGGTCTGAGAGGATGAACGGCCACATTGGGACTGAGACACGGCCCAAACTCCTACGGGAGGCAGCAGTGGGGAATCTTCCGCAATGGACGAAAGTCTGACGGAGCAACGCCGCGTGAGTGATGAAGGTC-TT-CGGA-TTGTAAAGCTCTGTTAATCGG-GACGAAAGAGT--TCTGTG--T-A-AATAATGCAGA-AAA-GTGACGGTACCGGAA-TAGAAAGCCACGGCTAACTACGTG
Firmicutes_-CCCAAAATCGAGATCTTGTTGCAGAAACGAC-	----------------------------ACGGCCCACCAAGGCAATGATCAGTAGCCGGTCTGAGAGGATGAACGGCCACATTGGGACTGAGACACGGCCCAAACTCCTACGGGAGGCAGCAGTGGGGAATCTTCCGCAATGGACGAAAGTCTGACGGAGCAACGCCGCGTGAGTGATGAAGGTC-TT-CGGA-TTGTAAAGCTCTGTTAATCGG-GACGAAAGAGT--TCTGTG--T-G-AATAATGCAGA-AAA-GTGACGGTACCGGAA-TAGAAAGCCACGGCTAACTACGTG
Firmicutes_-CCCAAAATCGAGGCTCTGTTTAGAGGACGAC-	----------------------------ACGGCCCACCAAGGCAATGATCAGTAGCCGGTCTGAGAGGATGAACGGCCACATTGGGACTGAGACACGGCCCAGACTCCTACGGGAGGCAGCAGTGGGGAATCTTCCGCAATGGACGAAAGTCTGACGGAGCAACGCCGCGTGAGTGATGACGGCC-TT-CGGG-TTGTAAAGCTCTGTTAATCGG-GACGAAAGGTC--CTCTTG--C-G-AATAGTTAGAG-GAA-TTGACGGTACCGGAA-TAGAAAGCCACGGCTAACTACGTG
Firmicutes_-CCCAAAATCGAGGTTCTGTTTAGAAGACGAC-	----------------------------ACGGCCCACCAAGGCAATGATCAGTAGCCGGTCTGAGAGGATGAACGGCCACATTGGGACTGAGACACGGCCCAGACTCCTACGGGAGGCAGCAGTGGGGAATCTTCCGCAATGGACGAAAGTCTGACGGAGCAACGCCGCGTGAGTGATGACGGCC-TT-CGGG-TTGTAAAGCTCTGTTAATCGG-GACGAAAGGTC--TTCTTG--C-G-AATAGTTAGAA-GAA-TTGACGGTACCGGAA-TAGAAAGCCACGGCTAACTACGTG
Firmicutes_-CCCAAAATCGAGGTTCTGTTTAGAAGGCGAC-	----------------------------ACGGCCCACCAAGGCAATGATCAGTAGCCGGTCTGAGAGGATGAACGGCCACATTGGGACTGAGACACGGCCCAGACTCCTACGGGAGGCAGCAGTGGGGAATCTTCCGCAATGGACGAAAGTCTGACGGAGCAACGCCGCGTGAGTGATGACGGCC-TT-CGGG-TTGTAAAGCTCTGTTAATCGG-GACGAAAGGCC--TTCTTG--C-G-AATAGTTAGAA-GGA-TTGACGGTACCGGAA-TAGAAAGCCACGGCTAACTACGTG
Firmicutes_-CCCAAAATCGAGGTTCTGTTTAGAGGACGAC-	----------------------------ACGGCCCACCAAGGCAATGATCAGTAGCCGGTCTGAGAGGATGAACGGCCACATTGGGACTGAGACACGGCCCAGACTCCTACGGGAGGCAGCAGTGGGGAATCTTCCGCAATGGACGAAAGTCTGACGGAGCAACGCCGCGTGAGTGATGACGGCC-TT-CGGG-TTGTAAAGCTCTGTTAATCGG-GACGAAAGGTC--TTCTTG--C-G-AATAGTTAGAG-GAA-TTGACGGTACCGGAA-TAGAAAGCCACGGCTAACTACGTG
Firmicutes_-CCCAAAATCGTGGACCTGTTTTGGGAGCGAC-	----------------------------ACGGCCCACCAAGGCAATGATCAGTAGCCGGTCTGAGAGGATGAACGGCCACATTGGGACTGAGACACGGCCCAAACTCCTACGGGAGGCAGCAGTGGGGAATCTTCCGCAATGGACGAAAGTCTGACGGAGCAACGCCGCGTGAGTGATGACGGCC-TT-CGGG-TTGTAAAGCTCTGTTAATCGG-GACGAATGGCT--ACCATG--C-G-AATAGTTTGGG-AGT-TTGACGGTACCGGAA-TAGAAAGCCACGGCTAACTACGTG
Firmicutes_-CCCAAAATCGTGGCTTTATTGCGAGGACGAC-	----------------------------ACGGCCCACCAAGGCAATGATCAGTAGCCGGTCTGAGAGGATGAACGGCCACATTGGGACTGAGACACGGCCCAGACTCCTACGGGAGGCAGCAGTGGGGAATCTTCCGCAATGGACGAAAGTCTGACGGAGCAACGCCGCGTGAGTGATGACGGCC-TT-CGGG-TTGTAAAGCTCTGTTAATCGG-GACGAATGGTT--CTTGTG--C-A-AATAGTGCGAG-GAT-TTGACGGTACCGGAA-TAGAAAGCCACGGCTAACTACGTG
Firmicutes_-CCCAGAACCG---GTATTA--------CTCC-	----------------------GAGGTAACGGCCCACCAAGACGATGATGCGTAGCCGGCCTGAGAGGGTGAACGGCCACATTGGGACTGAGACACGGCCCAGACTCCTACGGGAGGCAGCAGTAGGGAATTTTCGGCAATGGGGGAAACCCTGACCGAGCAACGCCGCGTGAGTGATGACGGCC-TT-CGGG-TTGTAAAGCTCTGTTGTAAGG-GAAGA------AGGTAGTAGGATTCAAA--------------TGACGGTACCTTAC-CAGAAAGCCACGGCTAACTACGTG
Firmicutes_-CCCAGAACCGAAGAGATGGCAAACTGCCGAC-	----------------------------ACGGCCCACCAAGGCGACGATCAGTAGCCGGTCTGAGAGGATGAACGGCCACACTGGAACTGAGACACGGTCCAGACTCCTACGGGAGGCAGCAGTGGGGAATCTTCCGCAATGGGCGAAAGCCTGACGGAGCAACGCCGCGTGAGTGATGACGGCC-TT-CGGG-TTGTAAAACTCTGTGATCCGG-GACGAAAAGGC--AGAGTG--C-G-AAGAACAAACT-GCA-TTGACGGTACCGGAA-AAGCAAGCCACGGCTAACTACGTG
Firmicutes_-CCCAGAACCGCGGTAGTAAATCTA---CTCC-	----------------------GAGGTAACGGCCCACCAAGACGATGATGCGTAGCCGGCCTGAGAGGGTGAACGGCCACATTGGGACTGAGACACGGCCCAGACTCCTACGGGAGGCAGCAGTAGGGAATTTTCGGCAATGGGGGAAACCCTGACCGAGCAACGCCGCGTGAGTGATGACGGCC-TT-CGGG-TTGTAAAGCTCTGTTGTAAGG-GAAGAACGG----TAGATA--G-A-GAA-TATCTA----A-GTGACGGTACCTTAC-CAGAAAGCCACGGCTAACTACGTG
Firmicutes_-CCCAGAACCGTAATTGGTTCCATAAGACTAC-	----------------------------ACGGCCCACCAAGGCGACGATCAGTAGCCGGTCTGAGAGGATGAACGGCCACATTGGAACTGAGACACGGTCCAGACTCCTACGGGAGGCAGCAGTGGGGAATCTTCCGCAATGGGCGAAAGCCTGACGGAGCAACGCCGCGTGAGTGAAGACGGCC-TT-CGGG-TTGTAAAGCTCTGTTATACGG-GACGAATAATC--TTGTGG--T-T-AATACCCATAA-GAA-GTGACGGTACCGTAA-GAGAAAGCCACGGCTAACTACGTG
Firmicutes_-CCCAGAACCGTAATTGGTTCCATGAGACTAC-	----------------------------ACGGCCCACCAAGGCGACGATCAGTAGCCGGTCTGAGAGGATGAACGGCCACATTGGAACTGAGACACGGTCCAGACTCCTACGGGAGGCAGCAGTGGGGAATCTTCCGCAATGGGCGAAAGCCTGACGGAGCAACGCCGCGTGAGTGAAGACGGCC-TT-CGGG-TTGTAAAGCTCTGTTATACGG-GACGAATAATC--TTGTGG--T-T-AATACCCATGA-GAA-GTGACGGTACCGTAA-GAGAAAGCCACGGCTAACTACGTG
Firmicutes_-CCCAGAACCGTAGTTGGTTCCATAAGACTAC-	----------------------------ACGGCCCACCAAGGCGACGATCAGTAGCCGGTCTGAGAGGATGAACGGCCACATTGGAACTGAGACACGGTCCAGACTCCTACGGGAGGCAGCAGTGGGGAATCTTCCGCAATGGGCGAAAGCCTGACGGAGCAACGCCGCGTGAGTGAAGACGGCC-TT-CGGG-TTGTAAAGCTCTGTTATACGG-GACGAATAGTC--TTGTGG--T-T-AATACCCATAA-GAA-GTGACGGTACCGTAA-GAGAAAGCCACGGCTAACTACGTG
Firmicutes_-CCCAGAACCGTAGTTGGTTCCATGAGACTAC-	----------------------------ACGGCCCACCAAGGCGACGATCAGTAGCCGGTCTGAGAGGATGAACGGCCACATTGGAACTGAGACACGGTCCAGACTCCTACGGGAGGCAGCAGTGGGGAATCTTCCGCAATGGGCGAAAGCCTGACGGAGCAACGCCGCGTGAGTGAAGACGGCC-TT-CGGG-TTGTAAAGCTCTGTTATACGG-GACGAATAGTC--TTGTGG--T-T-AATACCCATGA-GAA-GTGACGGTACCGTAA-GAGAAAGCCACGGCTAACTACGTG
Firmicutes_-CCCAGAATCGAGGCTCTGTTTAGAGGACGAC-	----------------------------ACGGCCCACCAAGGCGATGATCAGTAGCCGGTCTGAGAGGATGAACGGCCACATTGGGACTGAGACACGGCCCAGACTCCTACGGGAGGCAGCAGTGGGGAATCTTCCGCAATGGACGAAAGTCTGACGGAGCAACGCCGCGTGAGTGATGACGGCC-TT-CGGG-TTGTAAAGCTCTGTTAATCGG-GACGAAAGGTC--CTCTTG--C-G-AATAGTTAGAG-GAA-TTGACGGTACCGGAA-TAGAAAGCCACGGCTAACTACGTG
Firmicutes_-CCCAGAATCGAGGTTCTATTGAGAAGGCGAC-	----------------------------ACGGCCCACCAAGGCGATGATCAGTAGCCGGTCTGAGAGGATGAACGGCCACATTGGGACTGAGACACGGCCCAGACTCCTACGGGAGGCAGCAGTGGGGAATCTTCCGCAATGGACGAAAGTCTGACGGAGCAACGCCGCGTGAGTGATGACGGCC-TT-C-GGGTTGTAAAGCTCTGTTAATCGG-GACGAAAGGCC--TTCTTG--C-A-AATAGTGAGAA-GGA-TTGACGGTACCGGAA-TAGAAAGCCACGGCTAACTACGTG
Firmicutes_-CCCAGAATCGAGGTTCTGCTTAGAAGGCGAC-	----------------------------ACGGCCCACCAAGGCGATGATCAGTAGCCGGTCTGAGAGGATGAACGGCCACATTGGGACTGAGACACGGCCCAGACTCCTACGGGAGGCAGCAGTGGGGAATCTTCCGCAATGGACGAAAGTCTGACGGAGCAACGCCGCGTGAGTGATGACGGCC-TT-CGGG-TTGTAAAGCTCTGTTAATCGG-GACGAAAGGCC--TTCTTG--C-G-AACAGTTAGAA-GGA-TTGACGGTACCGGAA-TAGAAAGCCACGGCTAACTACGTG
Firmicutes_-CCCAGAATCGAGGTTCTGTTGAGAAGGCGAC-	----------------------------ACGGCCCACCAAGGCGATGATCAGTAGCCGGTCTGAGAGGATGAACGGCCACATTGGGACTGAGACACGGCCCAGACTCCTACGGGAGGCAGCAGTGGGGAATCTTCCGCAATGGACGAAAGTCTGACGGAGCAACGCCGCGTGAGTGATGACGGCC-TT-C-GGGTTGTAAAGCTCTGTTAATCGG-GACGAAAGGCC--TTCTTG--C-G-AATAGTGAGAA-GGA-TTGACGGTACCGGAA-TAGAAAGCCACGGCTAACTACGTG
Firmicutes_-CCCAGAATCGAGGTTCTGTTTAGAAGACGAC-	----------------------------ACGGCCCACCAAGGCGATGATCAGTAGCCGGTCTGAGAGGATGAACGGCCACATTGGGACTGAGACACGGCCCAGACTCCTACGGGAGGCAGCAGTGGGGAATCTTCCGCAATGGACGAAAGTCTGACGGAGCAACGCCGCGTGAGTGATGACGGCC-TT-CGGG-TTGTAAAGCTCTGTTAATCGG-GACGAAAGGTC--TTCTTG--C-G-AATAGTTAGAA-GAA-TTGACGGTACCGGAA-TAGAAAGCCACGGCTAACTACGTG
Firmicutes_-CCCAGAATCGAGGTTCTGTTTAGAAGGCGAC-	----------------------------ACGGCCCACCAAGGCGATGATCAGTAGCCGGTCTGAGAGGATGAACGGCCACATTGGGACTGAGACACGGCCCAGACTCCTACGGGAGGCAGCAGTGGGGAATCTTCCGCAATGGACGAAAGTCTGACGGAGCAACGCCGCGTGAGTGATGACGGCC-TT-CGGG-TTGTAAAGCTCTGTTAATCGG-GACGAAAGGCC--TTCTTG--C-G-AATAGTTAGAA-GGA-TTGACGGTACCGGAA-TAGAAAGCCACGGCTAACTACGTG
Firmicutes_-CCCAGAATCGTGGCTTTATTGCAAGGACGAC-	----------------------------ACGGCCCACCAAGGCGATGATCAGTAGCCGGTCTGAGAGGATGAACGGCCACATTGGGACTGAGACACGGCCCAGACTCCTACGGGAGGCAGCAGTGGGGAATCTTCCGCAATGGACGAAAGTCTGACGGAGCAACGCCGCGTGAGTGATGACGGCC-TT-CGGG-TTGTAAAGCTCTGTTAATCGG-GACGAATGGTT--CTTGTG--C-A-AATAGTGCAAG-GAT-TTGACGGTACCGGAA-TAGAAAGCCACGGCTAACTACGTG
Firmicutes_-CCCAGAATCGTGGCTTTATTGCGAGGACGAC-	----------------------------ACGGCCCACCAAGGCGATGATCAGTAGCCGGTCTGAGAGGATGAACGGCCACATTGGGACTGAGACACGGCCCAGACTCCTACGGGAGGCAGCAGTGGGGAATCTTCCGCAATGGACGAAAGTCTGACGGAGCAACGCCGCGTGAGTGATGACGGCC-TT-CGGG-TTGTAAAGCTCTGTTAATCGG-GACGAATGGTT--CTTGTG--C-A-AATAGTGCGAG-GAT-TTGACGGTACCGGAA-TAGAAAGCCACGGCTAACTACGTG
Firmicutes_-CCCAGAATCGTGGCTTTGTTGCAAGGACGAC-	----------------------------ACGGCCCACCAAGGCGATGATCAGTAGCCGGTCTGAGAGGATGAACGGCCACATTGGGACTGAGACACGGCCCAGACTCCTACGGGAGGCAGCAGTGGGGAATCTTCCGCAATGGACGAAAGTCTGACGGAGCAACGCCGCGTGAGTGATGACGGCC-TT-CGGG-TTGTAAAGCTCTGTTAATCGG-GACGAATGGTT--CTTGTG--C-G-AATAGTGCAAG-GAT-TTGACGGTACCGGAA-TAGAAAGCCACGGCTAACTACGTG
Firmicutes_-CCCAGAATCGTGGCTTTGTTGCGAGGACGAC-	----------------------------ACGGCCCACCAAGGCGATGATCAGTAGCCGGTCTGAGAGGATGAACGGCCACATTGGGACTGAGACACGGCCCAGACTCCTACGGGAGGCAGCAGTGGGGAATCTTCCGCAATGGACGAAAGTCTGACGGAGCAACGCCGCGTGAGTGATGACGGCC-TT-CGGG-TTGTAAAGCTCTGTTAATCGG-GACGAATGGTT--CTTGTG--C-G-AATAGTGCGAG-GAT-TTGACGGTACCGGAA-TAGAAAGCCACGGCTAACTACGTG
Firmicutes_-CCCAGACCCGCGGTAGTAAATCTA---CTCC-	----------------------GAGGTAACGGCCCACCAAGACGATGATGCGTAGCCGGCCTGAGAGGGTGAACGGCCACATTGGGACTGAGACACGGCCCAGACTCCTACGGGAGGCAGCAGTAGGGAATTTTCGGCAATGGGGGCAACCCTGACCGAGCAACGCCGCGTGAGTGAAGACGGCC-TT-CGGG-TTGTAAAGCTCTGTTGTAAGG-GAAGAACGG----TAGATA--G-A-GAA-TATCTA----A-GTGACGGTACCTTAC-CAGAAAGCCACGGCTAACTACGTG
Firmicutes_-CCCAGTGTTGCGAGTGGTAGTTCACACTTCG-	----------------------------ACGGCCCACCAAGGCGACGATACATAGCCGACCTGAGAGGGTGATCGGCCACACTGGGACTGAGACACGGCCCAGACTCCTACGGGAGGCAGCAGTAGGGAATCTTCGGCAATGGACGGAAGTCTGACCGAGCAACGCCGCGTGAGTGAAGAAGGTT-TT-CGGA-TCGTAAAGCTCTGTTGTAAGA-GAAGAACGAGT--GTGAGA--G-T-GGAAAGTTCAC-ACT-GTGACGGTATCTTAC-CAGAAAGGGACGGCTAACTACGTG
Firmicutes_-CCCATAACCGCGGCGTATTCTTATGGACGAC-	----------------------------ACGGCCCACCAAACCTACGATCAGTAGCCGGTCTGAGAGGATGAACGGCCACACTGGAACTGAGACACGGTCCAGACTCCTACGGGAGGCAGCAGTGGGGAATCTTCCGCAATGGGCGAAAGCCTGACGGAGCAACGCCGCGTGAGTGATGACGGCC-TT-CGGG-TTGTAAAGCTCTGTGATCGGG-GACGAACGGTC--CGTAAG--C-T-AATACCTTATG-GAA-GTGACGGTACCCGAA-TAGCAAGCCACGGCTAACTACGTG
Firmicutes_-CCTAATCTCGCAGCATGTCGTTATGCGTACC-	---------------------------AACGGCCTACCAAGGCAATGATGCATAGCCGACCTGAGAGGGTGATCGGCCACATTGGGACTGAGACACGGCCCAAACTCCTACGGGAGGCAGCAGTAGGGAATCTTCCGCAATGGACGCAAGTCTGACGGAGCAACGCCGCGTGAGTGAAGAAGGTC-TT-CGGA-TCGTAAAGCTCTGTTGTTAGA-GAAGAACAGCG--CATAGA--G-T-AAC-TGTTATG-CGT-GTGACGGTATCTAAC-CAGAAAGCCACGGCTAACTACGTG
Firmicutes_-CCTAGAACCGTGTGCATACCATTGTGTCGCC-	----------------------------ACGGCCTACCAAGGCGACGATCAGTAGCCGGTCTGAGAGGATGAACGGCCACATTGGGACTGAGACACGGCCCAGACTCCTACGGGAGGCAGCAGTGGGGAATCTTCCGCAATGGGCGAAAGCCTGACGGAGCAACGCCGCGTGAGTGAAGAAGGTC-TT-CGGA-TCGTAAAGCTCTGTTGCCGGG-GACGAATGTAG--GCAGTG--C-A-AACAGCATTGT-GTA-ATGACGGTACCCGGC-GAGGAAGCCACGGCTAACTACGTG
Firmicutes_-CCTAGAATTGCGTAGTTGCTGCATTGCGACC-	----------------------------ACGGACTACCAAGGCGATGATCAGTAGCCGGTCTGAGAGGATGAACGGCCACATTGGGACTGAGACACGGCCCAAACTCCTACGGGAGGCAGCAGTGGGGAATCTTCCGCAATGGACGAAAGTCTGACGGAGCAACGCCGCGTGAGTGATGAAGGAT-TT-CGGT-CTGTAAAGCTCTGTTGTTTAT-GACGAACGTGC--AGTGTG--T-G-AACAATGCATT-GCA-ATGACGGTAGTAAAC-GAGGAAGCCACGGCTAACTACGTG
Firmicutes_-CCTAGTCTCGCAGCATGTCGTTATGCGTACC-	---------------------------AACGGCCTACCAAGGCGATGATGCATAGCCGACCTGAGAGGGTGATCGGCCACATTGGGACTGAGACACGGCCCAAACTCCTACGGGAGGCAGCAGTAGGGAATCTTCCGCAATGGACGCAAGTCTGACGGAGCAACGCCGCGTGAGTGAAGAAGGTC-TT-CGGA-TCGTAAAGCTCTGTTGTTAGA-GAAGAACAGCG--CATAGA--G-T-AAC-TGTTATG-CGT-GTGACGGTATCTAAC-CAGAAAGCCACGGCTAACTACGTG
Firmicutes_-CTCAATATTGCGAGTGGTAGTTCACACTTCG-	----------------------------ACGGCTCACCAAGGCAACGATACATAGCCGACCTGAGAGGGTGATCGGCCACACTGGGACTGAGACACGGCCCAGACTCCTACGGGAGGCAGCAGTAGGGAATCTTCGGCAATGGACGAAAGTCTGACCGAGCAACGCCGCGTGAGTGAAGAAGGTT-TT-CGGA-TCGTAAAGCTCTGTTGTAAGA-GAAGAACGAGT--GTGAGA--G-T-GGAAAGTTCAC-ACT-GTGACGGTATCTTAC-CAGAAAGGGACGGCTAACTACGTG
Firmicutes_-CTCAATCCTCCGAGTGGTAGTTCACACGTCG-	----------------------------ACGGCTCACCAAGGCAACGATACATAGCCGACCTGAGAGGGTGATCGGCCACACTGGGACTGAGACACGGCCCAGACTCCTACGGGAGGCAGCAGTAGGGAATCTTCGGCAATGGGGGCAACCCTGACCGAGCAACGCCGCGTGAGTGAAGAAGGTT-TT-CGGA-TCGTAAAGCTCTGTTGTAAGT-CAAGAACGAGT--GTGAGA--G-T-GGAAAGTTCAC-ACT-GTGACGGTAGCTTAC-CAGAAAGGGACGGCTAACTACGTG
Firmicutes_-CTCAATCCTGCGAGTGGTAGTTCACACATCG-	----------------------------ACGGCTCACCAAGGCAACGATACATAGCCGACCTGAGAGGGTGATCGGCCACACTGGGACTGAGACACGGCCCAGACTCCTACGGGAGGCAGCAGTAGGGAATCTTCGGCAATGGGGGCAACCCTGACCGAGCAACGCCGCGTGAGTGAAGAAGGTT-TT-CGGA-TCGTAAAGCTCTGTTGTAAGA-GAAGAACGAGT--GTGAGA--G-T-GGAAAGTTCAC-ACT-GTGACGGTAACTTAC-CAGAAAGGGACGGCTAACTACGTG
Firmicutes_-CTCAATGTTGCGAGTGGTAGTTCACACATCG-	----------------------------ACGGCTCACCAAGGCAACGATACATAGCCGACCTGAGAGGGTGATCGGCCACACTGGGACTGAGACACGGCCCAGACTCCTACGGGAGGCAGCAGTAGGGAATCTTCGGCAATGGACGGAAGTCTGACCGAGCAACGCCGCGTGAGTGAAGAAGGTT-TT-CGGA-TCGTAAAGCTCTGTTGTAAGA-GAAGAACGAGT--GTGAGA--G-T-GGAAAGTTCAC-ACT-GTGACGGTAACTTAC-CAGAAAGGGACGGCTAACTACGTG
Firmicutes_-CTCAATGTTGCGAGTGGTAGTTCACACTTCG-	----------------------------ACGGCTCACCAAGGCAACGATACATAGCCGACCTGAGAGGGTGATCGGCCACACTGGGACTGAGACACGGCCCAGACTCCTACGGGAGGCAGCAGTAGGGAATCTTCGGCAATGGACGGAAGTCTGACCGAGCAACGCCGCGTGAGTGAAGAAGGTT-TT-CGGA-TCGTAAAGCTCTGTTGTAAGA-GAAGAACGAGT--GTGAGA--G-T-GGAAAGTTCAC-ACT-GTGACGGTATCTTAC-CAGAAAGGGACGGCTAACTACGTG
Firmicutes_-CTCAATGTTGCGAGTGGTAGTTTACACTTCG-	----------------------------ACGGCTCACCAAGGCAACGATACATAGCCGACCTGAGAGGGTGATCGGCCACACTGGGACTGAGACACGGCCCAGACTCCTACGGGAGGCAGCAGTAGGGAATCTTCGGCAATGGACGGAAGTCTGACCGAGCAACGCCGCGTGAGTGAAGAAGGTT-TT-CGGA-TCGTAAAGCTCTGTTGTAAGA-GAAGAACGAGT--GTGAGA--G-T-GGAAAGTTTAC-ACT-GTGACGGTATCTTAC-CAGAAAGGGACGGCTAACTACGTG
Firmicutes_-CTCAATGTTGCGGGTGGTAGTTCACACTTCG-	----------------------------ACGGCTCACCAAGGCAACGATACATAGCCGACCTGAGAGGGTGATCGGCCACACTGGGACTGAGACACGGCCCAGACTCCTACGGGAGGCAGCAGTAGGGAATCTTCGGCAATGGACGGAAGTCTGACCGAGCAACGCCGCGTGAGTGAAGAAGGTT-TT-CGGA-TCGTAAAGCTCTGTTGTAAGA-GAAGAACGGGT--GTGAGA--G-T-GGAAAGTTCAC-ACT-GTGACGGTATCTTAC-CAGAAAGGGACGGCTAACTACGTG
Firmicutes_-CTCACTCTTGCAAGCTGTCGTTAGCACTACC-	---------------------------AACGGCTCACCAAGGCCGTGATGCATAGCCGACCTGAGAGGGTGATCGGCCACATTGGGACTGAGACACGGCCCAAACTCCTACGGGAGGCAGCAGTAGGGAATCTTCCGCAATGGACGCAAGTCTGACGGAGCAACGCCGCGTGAGTGAAGAAGGTT-TT-CGGA-TCGTAAAACTCTGTTGTTAGA-GAAGAACAAGT--GCTAGA--G-T-AAC-TGTTAGC-ACC-TTGACGGTATCTAAC-CAGAAAGCCACGGCTAACTACGTG
Firmicutes_-CTCACTCTTGCAAGCTGTCGTTAGCGCTACC-	---------------------------AACGGCTCACCAAGGCCGTGATGCATAGCCGACCTGAGAGGGTGATCGGCCACATTGGGACTGAGACACGGCCCAAACTCCTACGGGAGGCAGCAGTAGGGAATCTTCCGCAATGGACGCAAGTCTGACGGAGCAACGCCGCGTGAGTGAAGAAGGTT-TT-CGGA-TCGTAAAACTCTGTTGTTAGA-GAAGAACAAGT--GCTAGA--G-T-AAC-TGTTAGC-GCC-TTGACGGTATCTAAC-CAGAAAGCCACGGCTAACTACGTG
Firmicutes_-CTCACTCTTGCAGCATGTCGTTATGCGTACC-	---------------------------AACGGCTCACCAAGGCCGTGATGCATAGCCGACCTGAGAGGGTGATCGGCCACATTGGGACTGAGACACGGCCCAAACTCCTACGGGAGGCAGCAGTAGGGAATCTTCCGCAATGGACGCAAGTCTGACGGAGCAACGCCGCGTGAGTGAAGAAGGAT-TT-CGGT-TCGTAAAACTCTGTTGTTAGA-GAAGAACAGCG--CATAGA--G-T-AAC-TGTTATG-CGT-GTGACGGTATCTAAC-CAGAAAGCCACGGCTAACTACGTG
Firmicutes_-CTCACTGTTGCGAGTGGTAGTTCACACTTCG-	----------------------------ACGGCTCACCAAGGCCACGATACATAGCCGACCTGAGAGGGTGATCGGCCACACTGGGACTGAGACACGGCCCAGACTCCTACGGGAGGCAGCAGTAGGGAATCTTCGGCAATGGACGGAAGTCTGACCGAGCAACGCCGCGTGAGTGAAGAAGGTT-TT-CGGA-TCGTAAAGCTCTGTTGTAAGA-GAAGAACGAGT--GTGAGA--G-T-GGAAAGTTCAC-ACT-GTGACGGTATCTTAC-CAGAAAGGGACGGCTAACTACGTG
Firmicutes_-CTCAGAATCGAGGTTGGGTTCATAGACCAAC-	----------------------------ACGGCTCACCAAGCCGACGATCAGTAGCCGGTCTGAGAGGATGAACGGCCACACTGGAACTGAGACACGGTCCAGACTCCTACGGGAGGCAGCAGTGGGGAATCTTCCGCAATGGACGAAAGTCTGACGGAGCAACGCCGCGTGAACGAAGAAGGTC-TT-CGGA-TTGTAAAGTTCTGTGATTCGG-GACGAAAGGGT--TTGTGG--T-G-AATAATCATAG-ACA-TTGACGGTACCGAAA-AAGCAAGCCACGGCTAACTACGTG
Firmicutes_-CTCAGAATTGAGGC---GA-----GAGCGGT-	----------------GTTGGTGAGGTAACGGCTCACCAAAGCGACGATCAGTAGCCGGCCTGAGAGGGCGGACGGCCACATTGGGACTGAGACACGGCCCAGACTCCTACGGGAGGCAGCAGTGGGGGATATTGCACAATGGAGGAAACTCTGATGCAGCGACGCCGCGTGAGTGAAGAAGTAT-TT-CGGT-ATGTAAAGCTCTATCAGCAGG-GAAGAAAGGCT--C---------G-CAA-------G-AGAGATGACGGTACCTGAG-TAAGAAGCTCCGGCTAAATACGTG
Firmicutes_-CTCAGACCCGCGTAGATGTCGCTTTGTCGCC-	----------------------------ACGGCTCACCAAGGCGACGATCAGTAGCCGGTCTGAGAGGATGAACGGCCACATTGGGACTGAGACACGGCCCAGACTCCTACGGGAGGCAGCAGTGGGGAATCTTCCGCAATGGGCGCAAGCCTGACGGAGCAACGCCGCGTGAGTGAAGAAGGTC-TT-CGGA-TCGTAAAGCTCTGTTGACGGG-GACGAACGTAT--AGAGTG--C-G-AATAGCGCTTT-GTA-ATGACGGTACCTGTC-GAGGAAGCCACGGCTAACTACGTG
Firmicutes_-CTCAGACCCGCGTCTATGTTATTAGGTCGCC-	----------------------------ACGGCTCACCAAGGCGACGATCAGTAGCCGGTCTGAGAGGATGAACGGCCACATTGGGACTGAGACACGGCCCAGACTCCTACGGGAGGCAGCAGTGGGGAATCTTCCGCAATGGGCGCAAGCCTGACGGAGCAACGCCGCGTGAGTGAAGAAGGTC-TT-CGGA-TCGTAAAGCTCTGTTGACGGG-GACGAACGTGC--CTAGTG--C-G-AATAGTATTAG-GTA-ATGACGGTACCTGTC-GAGGAAGCCACGGCTAACTACGTG
Firmicutes_-CTCAGACCCGCGTGAAGGTTCCTTTGCCACC-	----------------------------ACGGCTCACCAAGGCGACGATCAGTAGCCGGTCTGAGAGGATGAACGGCCACATTGGGACTGAGACACGGCCCAGACTCCTACGGGAGGCAGCAGTGGGGAATCTTCCGCAATGGGCGCAAGCCTGACGGAGCAACGCCGCGTGAGTGAAGAAGGTC-TT-CGGA-TCGTAAAGCTCTGTTGATGGG-GACGAACGTGC--GAAGGG--T-G-AATAATCCTTT-GCA-ATGACGGTACCTATC-GAGGAAGCCACGGCTAACTACGTG
Firmicutes_-CTCAGACCCGCGTGGATATCGCTTTGTCGCC-	----------------------------ACGGCTCACCAAGGCGACGATCAGTAGCCGGTCTGAGAGGATGAACGGCCACATTGGGACTGAGACACGGCCCAGACTCCTACGGGAGGCAGCAGTGGGGAATCTTCCGCAATGGGCGCAAGCCTGACGGAGCAACGCCGCGTGAGTGAAGAAGGTC-TT-CGGA-TCGTAAAGCTCTGTTGACGGG-GACGAACGTGC--GGAGTG--C-A-AATAGCGCTTT-GTA-ATGACGGTACCTGTC-GAGGAAGCCACGGCTAACTACGTG
Firmicutes_-CTCAGACCCGCGTGGATGTCGCTTTGTCGCC-	----------------------------ACGGCTCACCAAGGCGACGATCAGTAGCCGGTCTGAGAGGATGAACGGCCACATTGGGACTGAGACACGGCCCAGACTCCTACGGGAGGCAGCAGTGGGGAATCTTCCGCAATGGGCGCAAGCCTGACGGAGCAACGCCGCGTGAGTGAAGAAGGTC-TT-CGGA-TCGTAAAGCTCTGTTGACGGG-GACGAACGTGC--GGAGTG--C-G-AATAGCGCTTT-GTA-ATGACGGTACCTGTC-GAGGAAGCCACGGCTAACTACGTG
Firmicutes_-CTCAGACCCGCGTGGATGTTGCTCTGTCACC-	----------------------------ACGGCTCACCAAGGCGACGATCAGTAGCCGGTCTGAGAGGATGAACGGCCACATTGGGACTGAGACACGGCCCAGACTCCTACGGGAGGCAGCAGTGGGGAATCTTCCGCAATGGGCGCAAGCCTGACGGAGCAACGCCGCGTGAGTGAAGAAGGTC-TT-CGGA-TCGTAAAGCTCTGTTGATGGG-GACGAACGTAC--GGAGTG--C-G-AATAGTGCTCT-GTA-ATGACGGTACCTATC-GAGGAAGCCACGGCTAACTACGTG
Firmicutes_-CTCAGACCCGCGTGGATGTTGCTCTGTCGCC-	----------------------------ACGGCTCACCAAGGCGACGATCAGTAGCCGGTCTGAGAGGATGAACGGCCACATTGGGACTGAGACACGGCCCAGACTCCTACGGGAGGCAGCAGTGGGGAATCTTCCGCAATGGGCGCAAGCCTGACGGAGCAACGCCGCGTGAGTGAAGAAGGTC-TT-CGGA-TCGTAAAGCTCTGTTGACGGG-GACGAACGTAC--GGAGTG--C-G-AATAGTGCTCT-GTA-ATGACGGTACCTGTC-GAGGAAGCCACGGCTAACTACGTG
Firmicutes_-CTCAGACCCGCGTGGGTGTCGCTTTGTCGCC-	----------------------------ACGGCTCACCAAGGCGACGATCAGTAGCCGGTCTGAGAGGATGAACGGCCACATTGGGACTGAGACACGGCCCAGACTCCTACGGGAGGCAGCAGTGGGGAATCTTCCGCAATGGGCGCAAGCCTGACGGAGCAACGCCGCGTGAGTGAAGAAGGTC-TT-CGGA-TCGTAAAGCTCTGTTGACGGG-GACGAACGTGC--GGGGTG--C-G-AATAGCGCTTT-GTA-ATGACGGTACCTGTC-GAGGAAGCCACGGCTAACTACGTG
Firmicutes_-CTCAGTATTGCGAGTGGTAGTTCACACTTCG-	----------------------------ACGGCTCACCAAGGCGACGATACATAGCCGACCTGAGAGGGTGATCGGCCACACTGGGACTGAGACACGGCCCAGACTCCTACGGGAGGCAGCAGTAGGGAATCTTCGGCAATGGACGAAAGTCTGACCGAGCAACGCCGCGTGAGTGAAGAAGGTT-TT-CGGA-TCGTAAAGCTCTGTTGTAAGA-GAAGAACGAGT--GTGAGA--G-T-GGAAAGTTCAC-ACT-GTGACGGTATCTTAC-CAGAAAGGGACGGCTAACTACGTG
Firmicutes_-CTCAGTATTGCGAGTGGTAGTTCACGCTTCG-	----------------------------ACGGCTCACCAAGGCGACGATACATAGCCGACCTGAGAGGGTGATCGGCCACACTGGGACTGAGACACGGCCCAGACTCCTACGGGAGGCAGCAGTAGGGAATCTTCGGCAATGGACGAAAGTCTGACCGAGCAACGCCGCGTGAGTGAAGAAGGTT-TT-CGGA-TCGTAAAGCTCTGTTGTAAGA-GAAGAACGAGT--GTGAGA--G-T-GGAAAGTTCAC-GCT-GTGACGGTATCTTAC-CAGAAAGGGACGGCTAACTACGTG
Firmicutes_-CTCAGTATTGCGGGTGGTAGTTCACACTTCG-	----------------------------ACGGCTCACCAAGGCGACGATACATAGCCGACCTGAGAGGGTGATCGGCCACACTGGGACTGAGACACGGCCCAGACTCCTACGGGAGGCAGCAGTAGGGAATCTTCGGCAATGGACGAAAGTCTGACCGAGCAACGCCGCGTGAGTGAAGAAGGTT-TT-CGGA-TCGTAAAGCTCTGTTGTAAGA-GAAGAACGGGT--GTGAGA--G-T-GGAAAGTTCAC-ACT-GTGACGGTATCTTAC-CAGAAAGGGACGGCTAACTACGTG
Firmicutes_-CTCAGTCCTCCGAGTGGTAGTTCACACGTCG-	----------------------------ACGGCTCACCAAGGCGACGATACATAGCCGACCTGAGAGGGTGATCGGCCACACTGGGACTGAGACACGGCCCAGACTCCTACGGGAGGCAGCAGTAGGGAATCTTCGGCAATGGGGGCAACCCTGACCGAGCAACGCCGCGTGAGTGAAGAAGGTT-TT-CGGA-TCGTAAAGCTCTGTTGTAAGT-CAAGAACGAGT--GTGAGA--G-T-GGAAAGTTCAC-ACT-GTGACGGTAGCTTAC-CAGAAAGGGACGGCTAACTACGTG
Firmicutes_-CTCAGTCCTGCGAGTGGTAGTTCACACATCG-	----------------------------ACGGCTCACCAAGGCGACGATACATAGCCGACCTGAGAGGGTGATCGGCCACACTGGGACTGAGACACGGCCCAGACTCCTACGGGAGGCAGCAGTAGGGAATCTTCGGCAATGGGGGCAACCCTGACCGAGCAACGCCGCGTGAGTGAAGAAGGTT-TT-CGGA-TCGTAAAGCTCTGTTGTAAGA-GAAGAACGAGT--GTGAGA--G-T-GGAAAGTTCAC-ACT-GTGACGGTAACTTAC-CAGAAAGGGACGGCTAACTACGTG
Firmicutes_-CTCAGTCCTGCGAGTGGTAGTTCACACTTCG-	----------------------------ACGGCTCACCAAGGCGACGATACATAGCCGACCTGAGAGGGTGATCGGCCACACTGGGACTGAGACACGGCCCAGACTCCTACGGGAGGCAGCAGTAGGGAATCTTCGGCAATGGGGGCAACCCTGACCGAGCAACGCCGCGTGAGTGAAGAAGGTT-TT-CGGA-TCGTAAAGCTCTGTTGTAAGA-GAAGAACGAGT--GTGAGA--G-T-GGAAAGTTCAC-ACT-GTGACGGTATCTTAC-CAGAAAGGGACGGCTAACTACGTG
Firmicutes_-CTCAGTCCTGCGAGTGGTAGTTCACGCTTCG-	----------------------------ACGGCTCACCAAGGCGACGATACATAGCCGACCTGAGAGGGTGATCGGCCACACTGGGACTGAGACACGGCCCAGACTCCTACGGGAGGCAGCAGTAGGGAATCTTCGGCAATGGGGGCAACCCTGACCGAGCAACGCCGCGTGAGTGAAGAAGGTT-TT-CGGA-TCGTAAAGCTCTGTTGTAAGA-GAAGAACGAGT--GTGAGA--G-T-GGAAAGTTCAC-GCT-GTGACGGTATCTTAC-CAGAAAGGGACGGCTAACTACGTG
Firmicutes_-CTCAGTCTTGCAGCATGTCGTTATGCGTACC-	---------------------------AACGGCTCACCAAGGCGATGATGCATAGCCGACCTGAGAGGGTGATCGGCCACATTGGGACTGAGACACGGCCCAAACTCCTACGGGAGGCAGCAGTAGGGAATCTTCCGCAATGGACGCAAGTCTGACGGAGCAACGCCGCGTGAGTGAAGAAGGAT-TT-CGGT-TCGTAAAACTCTGTTGTTAGA-GAAGAACAGCG--CATAGA--G-T-AAC-TGTTATG-CGT-GTGACGGTATCTAAC-CAGAAAGCCACGGCTAACTACGTG
Firmicutes_-CTCAGTGCTGCGAGTGGTAGTTCACACTTCG-	----------------------------ACGGCTCACCAAGGCGACGATACATAGCCGACCTGAGAGGGTGATCGGCCACACTGGGACTGAGACACGGCCCAGACTCCTACGGGAGGCAGCAGTAGGGAATCTTCGGCAATGGGGGGAACCCTGACCGAGCAACGCCGCGTGAGTGAAGAAGGTT-TT-CGGA-TCGTAAAGCTCTGTTGTAAGA-GAAGAACGAGT--GTGAGA--G-T-GGAAAGTTCAC-ACT-GTGACGGTATCTTAC-CAGAAAGGGACGGCTAACTACGTG
Firmicutes_-CTCAGTGCTGCGGGTGGTAGTTCACACTTCG-	----------------------------ACGGCTCACCAAGGCGACGATACATAGCCGACCTGAGAGGGTGATCGGCCACACTGGGACTGAGACACGGCCCAGACTCCTACGGGAGGCAGCAGTAGGGAATCTTCGGCAATGGGGGGAACCCTGACCGAGCAACGCCGCGTGAGTGAAGAAGGTT-TT-CGGA-TCGTAAAGCTCTGTTGTAAGA-GAAGAACGGGT--GTGAGA--G-T-GGAAAGTTCAC-ACT-GTGACGGTATCTTAC-CAGAAAGGGACGGCTAACTACGTG
Firmicutes_-CTCAGTGTTACGAGTGGTAGTTCACACTTCG-	----------------------------ACGGCTCACCAAGGCGACGATACATAGCCGACCTGAGAGGGTGATCGGCCACACTGGGACTGAGACACGGCCCAGACTCCTACGGGAGGCAGCAGTAGGGAATCTTCGGCAATGGACGGAAGTCTGACCGAGCAACGCCGCGTGAGTGAAGAAGGTT-TT-CGGA-TCGTAAAGCTCTGTTGTAAGA-AAAGAACGAGT--GTGAGA--G-T-GGAAAGTTCAC-ACT-GTGACGGTATCTTAC-CAGAAAGGGACGGCTAACTACGTG
Firmicutes_-CTCAGTGTTCCGAGTGGTAGTTCACACGTCG-	----------------------------ACGGCTCACCAAGGCGACGATACATAGCCGACCTGAGAGGGTGATCGGCCACACTGGGACTGAGACACGGCCCAGACTCCTACGGGAGGCAGCAGTAGGGAATCTTCGGCAATGGACGGAAGTCTGACCGAGCAACGCCGCGTGAGTGAAGAAGGTT-TT-CGGA-TCGTAAAGCTCTGTTGTAAGT-CAAGAACGAGT--GTGAGA--G-T-GGAAAGTTCAC-ACT-GTGACGGTAGCTTAC-CAGAAAGGGACGGCTAACTACGTG
Firmicutes_-CTCAGTGTTGCAAGTGGTAGTTCACACTTCG-	----------------------------ACGGCTCACCAAGGCGACGATACATAGCCGACCTGAGAGGGTGATCGGCCACACTGGGACTGAGACACGGCCCAGACTCCTACGGGAGGCAGCAGTAGGGAATCTTCGGCAATGGACGGAAGTCTGACCGAGCAACGCCGCGTGAGTGAAGAAGGTT-TT-CGGA-TCGTAAAGCTCTGTTGTAAGA-GAAGAACAAGT--GTGAGA--G-T-GGAAAGTTCAC-ACT-GTGACGGTATCTTAC-CAGAAAGGGACGGCTAACTACGTG
Firmicutes_-CTCAGTGTTGCAGGTGGTAGTTCACACTTCG-	----------------------------ACGGCTCACCAAGGCGACGATACATAGCCGACCTGAGAGGGTGATCGGCCACACTGGGACTGAGACACGGCCCAGACTCCTACGGGAGGCAGCAGTAGGGAATCTTCGGCAATGGACGGAAGTCTGACCGAGCAACGCCGCGTGAGTGAAGAAGGTT-TT-CGGA-TCGTAAAGCTCTGTTGTAAGA-GAAGAACAGGT--GTGAGA--G-T-GGAAAGTTCAC-ACT-GTGACGGTATCTTAC-CAGAAAGGGACGGCTAACTACGTG
Firmicutes_-CTCAGTGTTGCGAATGGTAGTTCATACTTCG-	----------------------------ACGGCTCACCAAGGCGACGATACATAGCCGACCTGAGAGGGTGATCGGCCACACTGGGACTGAGACACGGCCCAGACTCCTACGGGAGGCAGCAGTAGGGAATCTTCGGCAATGGACGGAAGTCTGACCGAGCAACGCCGCGTGAGTGAAGAAGGTT-TT-CGGA-TCGTAAAGCTCTGTTGTAAGA-GAAGAACGAGT--ATGAGA--G-T-GGAAAGTTCAT-ACT-GTGACGGTATCTTAC-CAGAAAGGGACGGCTAACTACGTG
Firmicutes_-CTCAGTGTTGCGAGCGGTAGTTCACACTTCG-	----------------------------ACGGCTCACCAAGGCGACGATACATAGCCGACCTGAGAGGGTGATCGGCCACACTGGGACTGAGACACGGCCCAGACTCCTACGGGAGGCAGCAGTAGGGAATCTTCGGCAATGGACGGAAGTCTGACCGAGCAACGCCGCGTGAGTGAAGAAGGTT-TT-CGGA-TCGTAAAGCTCTGTTGTAAGA-GAAGAACGAGT--GCGAGA--G-T-GGAAAGTTCAC-ACT-GTGACGGTATCTTAC-CAGAAAGGGACGGCTAACTACGTG
Firmicutes_-CTCAGTGTTGCGAGTGGCAGTTCACACTTCG-	----------------------------ACGGCTCACCAAGGCGACGATACATAGCCGACCTGAGAGGGTGATCGGCCACACTGGGACTGAGACACGGCCCAGACTCCTACGGGAGGCAGCAGTAGGGAATCTTCGGCAATGGACGGAAGTCTGACCGAGCAACGCCGCGTGAGTGAAGAAGGTT-TT-CGGA-TCGTAAAGCTCTGTTGTAAGA-GAAGAACGAGT--GTGAGA--G-C-GGAAAGTTCAC-ACT-GTGACGGTATCTTAC-CAGAAAGGGACGGCTAACTACGTG
Firmicutes_-CTCAGTGTTGCGAGTGGTAATTCACACTTCG-	----------------------------ACGGCTCACCAAGGCGACGATACATAGCCGACCTGAGAGGGTGATCGGCCACACTGGGACTGAGACACGGCCCAGACTCCTACGGGAGGCAGCAGTAGGGAATCTTCGGCAATGGACGGAAGTCTGACCGAGCAACGCCGCGTGAGTGAAGAAGGTT-TT-CGGA-TCGTAAAGCTCTGTTGTAAGA-GAAGAACGAGT--GTGAGA--G-T-GGAAAATTCAC-ACT-GTGACGGTATCTTAC-CAGAAAGGGACGGCTAACTACGTG
Firmicutes_-CTCAGTGTTGCGAGTGGTAGCTCACACTTCG-	----------------------------ACGGCTCACCAAGGCGACGATACATAGCCGACCTGAGAGGGTGATCGGCCACACTGGGACTGAGACACGGCCCAGACTCCTACGGGAGGCAGCAGTAGGGAATCTTCGGCAATGGACGGAAGTCTGACCGAGCAACGCCGCGTGAGTGAAGAAGGTT-TT-CGGA-TCGTAAAGCTCTGTTGTAAGA-GAAGAACGAGT--GTGAGA--G-T-GGAAAGCTCAC-ACT-GTGACGGTATCTTAC-CAGAAAGGGACGGCTAACTACGTG
Firmicutes_-CTCAGTGTTGCGAGTGGTAGTCCACACTTCG-	----------------------------ACGGCTCACCAAGGCGACGATACATAGCCGACCTGAGAGGGTGATCGGCCACACTGGGACTGAGACACGGCCCAGACTCCTACGGGAGGCAGCAGTAGGGAATCTTCGGCAATGGACGGAAGTCTGACCGAGCAACGCCGCGTGAGTGAAGAAGGTT-TT-CGGA-TCGTAAAGCTCTGTTGTAAGA-GAAGAACGAGT--GTGAGA--G-T-GGAAAGTCCAC-ACT-GTGACGGTATCTTAC-CAGAAAGGGACGGCTAACTACGTG
Firmicutes_-CTCAGTGTTGCGAGTGGTAGTTCACACATCG-	----------------------------ACGGCTCACCAAGGCGACGATACATAGCCGACCTGAGAGGGTGATCGGCCACACTGGGACTGAGACACGGCCCAGACTCCTACGGGAGGCAGCAGTAGGGAATCTTCGGCAATGGACGGAAGTCTGACCGAGCAACGCCGCGTGAGTGAAGAAGGTT-TT-CGGA-TCGTAAAGCTCTGTTGTAAGA-GAAGAACGAGT--GTGAGA--G-T-GGAAAGTTCAC-ACT-GTGACGGTAACTTAC-CAGAAAGGGACGGCTAACTACGTG
Firmicutes_-CTCAGTGTTGCGAGTGGTAGTTCACACCTCG-	----------------------------ACGGCTCACCAAGGCGACGATACATAGCCGACCTGAGAGGGTGATCGGCCACACTGGGACTGAGACACGGCCCAGACTCCTACGGGAGGCAGCAGTAGGGAATCTTCGGCAATGGACGGAAGTCTGACCGAGCAACGCCGCGTGAGTGAAGAAGGTT-TT-CGGA-TCGTAAAGCTCTGTTGTAAGA-GAAGAACGAGT--GTGAGA--G-T-GGAAAGTTCAC-ACT-GTGACGGTACCTTAC-CAGAAAGGGACGGCTAACTACGTG
Firmicutes_-CTCAGTGTTGCGAGTGGTAGTTCACACGTCG-	----------------------------ACGGCTCACCAAGGCGACGATACATAGCCGACCTGAGAGGGTGATCGGCCACACTGGGACTGAGACACGGCCCAGACTCCTACGGGAGGCAGCAGTAGGGAATCTTCGGCAATGGACGGAAGTCTGACCGAGCAACGCCGCGTGAGTGAAGAAGGTT-TT-CGGA-TCGTAAAGCTCTGTTGTAAGA-GAAGAACGAGT--GTGAGA--G-T-GGAAAGTTCAC-ACT-GTGACGGTAGCTTAC-CAGAAAGGGACGGCTAACTACGTG
Firmicutes_-CTCAGTGTTGCGAGTGGTAGTTCACACTTCG-	----------------------------ACGGCTCACCAAGGCGACGATACATAGCCGACCTGAGAGGGTGATCGGCCACACTGGGACTGAGACACGGCCCAGACTCCTACGGGAGGCAGCAGTAGGGAATCTTCGGCAATGGACGGAAGTCTGACCGAGCAACGCCGCGTGAGTGAAGAAGGTT-TT-CGGA-TCGTAAAGCTCTGTTGTAAGA-GAAGAACGAGT--GTGAGA--G-T-GGAAAGTTCAC-ACT-GTGACGGTATCTTAC-CAGAAAGGGACGGCTAACTACGTG
Firmicutes_-CTCAGTGTTGCGAGTGGTAGTTCACGCTTCG-	----------------------------ACGGCTCACCAAGGCGACGATACATAGCCGACCTGAGAGGGTGATCGGCCACACTGGGACTGAGACACGGCCCAGACTCCTACGGGAGGCAGCAGTAGGGAATCTTCGGCAATGGACGGAAGTCTGACCGAGCAACGCCGCGTGAGTGAAGAAGGTT-TT-CGGA-TCGTAAAGCTCTGTTGTAAGA-GAAGAACGAGT--GTGAGA--G-T-GGAAAGTTCAC-GCT-GTGACGGTATCTTAC-CAGAAAGGGACGGCTAACTACGTG
Firmicutes_-CTCAGTGTTGCGAGTGGTAGTTCATACTTCG-	----------------------------ACGGCTCACCAAGGCGACGATACATAGCCGACCTGAGAGGGTGATCGGCCACACTGGGACTGAGACACGGCCCAGACTCCTACGGGAGGCAGCAGTAGGGAATCTTCGGCAATGGACGGAAGTCTGACCGAGCAACGCCGCGTGAGTGAAGAAGGTT-TT-CGGA-TCGTAAAGCTCTGTTGTAAGA-GAAGAACGAGT--GTGAGA--G-T-GGAAAGTTCAT-ACT-GTGACGGTATCTTAC-CAGAAAGGGACGGCTAACTACGTG
Firmicutes_-CTCAGTGTTGCGAGTGGTAGTTCGCACTTCG-	----------------------------ACGGCTCACCAAGGCGACGATACATAGCCGACCTGAGAGGGTGATCGGCCACACTGGGACTGAGACACGGCCCAGACTCCTACGGGAGGCAGCAGTAGGGAATCTTCGGCAATGGACGGAAGTCTGACCGAGCAACGCCGCGTGAGTGAAGAAGGTT-TT-CGGA-TCGTAAAGCTCTGTTGTAAGA-GAAGAACGAGT--GTGAGA--G-T-GGAAAGTTCGC-ACT-GTGACGGTATCTTAC-CAGAAAGGGACGGCTAACTACGTG
Firmicutes_-CTCAGTGTTGCGAGTGGTGGTTCACACTTCG-	----------------------------ACGGCTCACCAAGGCGACGATACATAGCCGACCTGAGAGGGTGATCGGCCACACTGGGACTGAGACACGGCCCAGACTCCTACGGGAGGCAGCAGTAGGGAATCTTCGGCAATGGACGGAAGTCTGACCGAGCAACGCCGCGTGAGTGAAGAAGGTT-TT-CGGA-TCGTAAAGCTCTGTTGTAAGA-GAAGAACGAGT--GTGAGA--G-T-GGGAAGTTCAC-ACT-GTGACGGTATCTTAC-CAGAAAGGGACGGCTAACTACGTG
Firmicutes_-CTCAGTGTTGCGGGTGGTAGTTCACACTTCG-	----------------------------ACGGCTCACCAAGGCGACGATACATAGCCGACCTGAGAGGGTGATCGGCCACACTGGGACTGAGACACGGCCCAGACTCCTACGGGAGGCAGCAGTAGGGAATCTTCGGCAATGGACGGAAGTCTGACCGAGCAACGCCGCGTGAGTGAAGAAGGTT-TT-CGGA-TCGTAAAGCTCTGTTGTAAGA-GAAGAACGGGT--GTGAGA--G-T-GGAAAGTTCAC-ACT-GTGACGGTATCTTAC-CAGAAAGGGACGGCTAACTACGTG
Firmicutes_-CTCAGTGTTGTGAGTGGTAGTTCACACTTCG-	----------------------------ACGGCTCACCAAGGCGACGATACATAGCCGACCTGAGAGGGTGATCGGCCACACTGGGACTGAGACACGGCCCAGACTCCTACGGGAGGCAGCAGTAGGGAATCTTCGGCAATGGACGGAAGTCTGACCGAGCAACGCCGCGTGAGTGAAGAAGGTT-TT-CGGA-TCGTAAAGCTCTGTTGTAAGA-GAAGAATGAGT--GTGAGA--G-T-GGAAAGTTCAC-ACT-GTGACGGTATCTTAC-CAGAAAGGGACGGCTAACTACGTG
Firmicutes_-CTCATTGTTGCGAGTGGTAGTTCACACTTCG-	----------------------------ACGGCTCACCAAGGCTACGATACATAGCCGACCTGAGAGGGTGATCGGCCACACTGGGACTGAGACACGGCCCAGACTCCTACGGGAGGCAGCAGTAGGGAATCTTCGGCAATGGACGGAAGTCTGACCGAGCAACGCCGCGTGAGTGAAGAAGGTT-TT-CGGA-TCGTAAAGCTCTGTTGTAAGA-GAAGAACGAGT--GTGAGA--G-T-GGAAAGTTCAC-ACT-GTGACGGTATCTTAC-CAGAAAGGGACGGCTAACTACGTG
Firmicutes_-CTCTGACCCGCGTCTATGTTATTAGGTCACC-	----------------------------ACGGCTCACCTAGGCGACGATCAGTAGCCGGTCTGAGAGGATGAACGGCCACATTGGGACTGAGACACGGCCCAGACTCCTACGGGAGGCAGCAGTGGGGAATCTTCCGCAATGGGCGCAAGCCTGACGGAGCAACGCCGCGTGAGTGAAGAAGGTC-TT-CGGA-TCGTAAAGCTCTGTTGATGGG-GACGAACGTGC--CTAATG--C-G-AATAGTATTAG-GTA-ATGACGGTACCCATC-GAGGAAGCCACGGCTAACTACGTG
Firmicutes_-CTCTGACCCGCGTCTATGTTTTTAGGCCACC-	----------------------------ACGGCTCACCTAGGCGACGATCAGTAGCCGGTCTGAGAGGATGAACGGCCACATTGGGACTGAGACACGGCCCAGACTCCTACGGGAGGCAGCAGTGGGGAATCTTCCGCAATGGGCGCAAGCCTGACGGAGCAACGCCGCGTGAGTGAAGAAGGTC-TT-CGGA-TCGTAAAGCTCTGTTGATGGG-GACGAACGTGC--CTAATG--C-G-AATAGTTTTAG-GCA-ATGACGGTACCCATC-GAGGAAGCCACGGCTAACTACGTG
Firmicutes_-CTCTGACCCGCGTCTATGTTTTTAGGTCACC-	----------------------------ACGGCTCACCTAGGCGACGATCAGTAGCCGGTCTGAGAGGATGAACGGCCACATTGGGACTGAGACACGGCCCAGACTCCTACGGGAGGCAGCAGTGGGGAATCTTCCGCAATGGGCGCAAGCCTGACGGAGCAACGCCGCGTGAGTGAAGAAGGTC-TT-CGGA-TCGTAAAGCTCTGTTGATGGG-GACGAACGTGC--CTAATG--C-G-AATAGTTTTAG-GTA-ATGACGGTACCCATC-GAGGAAGCCACGGCTAACTACGTG
Firmicutes_-CTCTGTATTGCGGGTGGTAGTTCACACTTCG-	----------------------------ACGGCTCACCTAGGCGACGATACATAGCCGACCTGAGAGGGTGATCGGCCACACTGGGACTGAGACACGGCCCAGACTCCTACGGGAGGCAGCAGTAGGGAATCTTCGGCAATGGACGAAAGTCTGACCGAGCAACGCCGCGTGAGTGAAGAAGGTT-TT-CGGA-TCGTAAAGCTCTGTTGTAAGA-GAAGAACGGGT--GTGAGA--G-T-GGAAAGTTCAC-ACT-GTGACGGTATCTTAC-CAGAAAGGGACGGCTAACTACGTG
Firmicutes_-CTCTGTCCTCCGAGTGGTAATTCACACGTCG-	----------------------------ACGGCTCACCTAGGCGACGATACATAGCCGACCTGAGAGGGTGATCGGCCACACTGGGACTGAGACACGGCCCAGACTCCTACGGGAGGCAGCAGTAGGGAATCTTCGGCAATGGGGGCAACCCTGACCGAGCAACGCCGCGTGAGTGAAGAAGGTT-TT-CGGA-TCGTAAAGCTCTGTTGTAAGT-CAAGAACGAGT--GTGAGA--G-T-GGAAAATTCAC-ACT-GTGACGGTAGCTTAC-CAGAAAGGGACGGCTAACTACGTG
Firmicutes_-CTCTGTCCTCCGAGTGGTAGTTCACACGTCG-	----------------------------ACGGCTCACCTAGGCGACGATACATAGCCGACCTGAGAGGGTGATCGGCCACACTGGGACTGAGACACGGCCCAGACTCCTACGGGAGGCAGCAGTAGGGAATCTTCGGCAATGGGGGCAACCCTGACCGAGCAACGCCGCGTGAGTGAAGAAGGTT-TT-CGGA-TCGTAAAGCTCTGTTGTAAGT-CAAGAACGAGT--GTGAGA--G-T-GGAAAGTTCAC-ACT-GTGACGGTAGCTTAC-CAGAAAGGGACGGCTAACTACGTG
Firmicutes_-CTCTGTCCTCCGAGTGGTAGTTCACACTTCG-	----------------------------ACGGCTCACCTAGGCGACGATACATAGCCGACCTGAGAGGGTGATCGGCCACACTGGGACTGAGACACGGCCCAGACTCCTACGGGAGGCAGCAGTAGGGAATCTTCGGCAATGGGGGCAACCCTGACCGAGCAACGCCGCGTGAGTGAAGAAGGTT-TT-CGGA-TCGTAAAGCTCTGTTGTAAGT-CAAGAACGAGT--GTGAGA--G-T-GGAAAGTTCAC-ACT-GTGACGGTATCTTAC-CAGAAAGGGACGGCTAACTACGTG
Firmicutes_-CTCTGTCCTCTGAGTGGTAGTTCACACGTCG-	----------------------------ACGGCTCACCTAGGCGACGATACATAGCCGACCTGAGAGGGTGATCGGCCACACTGGGACTGAGACACGGCCCAGACTCCTACGGGAGGCAGCAGTAGGGAATCTTCGGCAATGGGGGCAACCCTGACCGAGCAACGCCGCGTGAGTGAAGAAGGTT-TT-CGGA-TCGTAAAGCTCTGTTGTAAGT-CAAGAATGAGT--GTGAGA--G-T-GGAAAGTTCAC-ACT-GTGACGGTAGCTTAC-CAGAAAGGGACGGCTAACTACGTG
Firmicutes_-CTCTGTCCTGCGAGTGGTAGTTCACACTTCG-	----------------------------ACGGCTCACCTAGGCGACGATACATAGCCGACCTGAGAGGGTGATCGGCCACACTGGGACTGAGACACGGCCCAGACTCCTACGGGAGGCAGCAGTAGGGAATCTTCGGCAATGGGGGCAACCCTGACCGAGCAACGCCGCGTGAGTGAAGAAGGTT-TT-CGGA-TCGTAAAGCTCTGTTGTAAGA-GAAGAACGAGT--GTGAGA--G-T-GGAAAGTTCAC-ACT-GTGACGGTATCTTAC-CAGAAAGGGACGGCTAACTACGTG
Firmicutes_-CTCTGTGCTGCGAGTGGTAGTTCATACCACG-	----------------------------ACGGCTCACCTAGGCGACGATACATAGCCGACCTGAGAGGGTGATCGGCCACACTGGGACTGAGACACGGCCCAGACTCCTACGGGAGGCAGCAGTAGGGAATCTTCGGCAATGGGGGGAACCCTGACCGAGCAACGCCGCGTGAGTGAAGAAGGTT-TT-CGGA-TCGTAAAGCTCTGTTGTTAAG-GAAGAACGAGT--GTGAGA--A-T-GGAAAGTTCAT-ACT-GTGACGGTACTTAAC-CAGAAAGGGACGGCTAACTACGTG
Firmicutes_-CTCTGTGTTGCGAGTGGTAGTTCACACTTCG-	----------------------------ACGGCTCACCTAGGCGACGATACATAGCCGACCTGAGAGGGTGATCGGCCACACTGGGACTGAGACACGGCCCAGACTCCTACGGGAGGCAGCAGTAGGGAATCTTCGGCAATGGACGGAAGTCTGACCGAGCAACGCCGCGTGAGTGAAGAAGGTT-TT-CGGA-TCGTAAAGCTCTGTTGTAAGA-GAAGAACGAGT--GTGAGA--G-T-GGAAAGTTCAC-ACT-GTGACGGTATCTTAC-CAGAAAGGGACGGCTAACTACGTG
Firmicutes_-CTTAGTGTTGCGAGTGGTAGTTCACACTTCG-	----------------------------ACGGCTTACCAAGGCGACGATACATAGCCGACCTGAGAGGGTGATCGGCCACACTGGGACTGAGACACGGCCCAGACTCCTACGGGAGGCAGCAGTAGGGAATCTTCGGCAATGGACGGAAGTCTGACCGAGCAACGCCGCGTGAGTGAAGAAGGTT-TT-CGGA-TCGTAAAGCTCTGTTGTAAGA-GAAGAACGAGT--GTGAGA--G-T-GGAAAGTTCAC-ACT-GTGACGGTATCTTAC-CAGAAAGGGACGGCTAACTACGTG
Firmicutes_-GCTAGTCTCGCAGCATGTCGTTATGCGTACC-	---------------------------AAGGGCCTACCAAGGCGATGATGCATAGCCGACCTGAGAGGGTGATCGGCCACATTGGGACTGAGACACGGCCCAAACTCCTACGGGAGGCAGCAGTAGGGAATCTTCCGCAATGGACGCAAGTCTGACGGAGCAACGCCGCGTGAGTGAAGAAGGTC-TT-CGGA-TCGTAAAGCTCTGTTGTTAGA-GAAGAACAGCG--CATAGA--G-T-AAC-TGTTATG-CGT-GTGACGGTATCTAAC-CAGAAAGCCACGGCTAACTACGTG
Firmicutes_-GTCAGTGTTGCGAGTGGTAGTTCACACTTCG-	----------------------------AGGGCTCACCAAGGCGACGATACATAGCCGACCTGAGAGGGTGATCGGCCACACTGGGACTGAGACACGGCCCAGACTCCTACGGGAGGCAGCAGTAGGGAATCTTCGGCAATGGACGGAAGTCTGACCGAGCAACGCCGCGTGAGTGAAGAAGGTT-TT-CGGA-TCGTAAAGCTCTGTTGTAAGA-GAAGAACGAGT--GTGAGA--G-T-GGAAAGTTCAC-ACT-GTGACGGTATCTTAC-CAGAAAGGGACGGCTAACTACGTG
Firmicutes_-GTTAGTATTCCGTGTGGTAGTTCACACGTCG-	----------------------------AGAGCTTACCAAGGCGACGATACATAGCCGACCTGAGAGGGTGATCGGCCACACTGGGACTGAGACACGGCCCAGACTCCTACGGGAGGCAGCAGTAGGGAATCTTCGGCAATGGACGAAAGTCTGACCGAGCAACGCCGCGTGAGTGAAGAAGGTT-TT-CGGA-TCGTAAAGCTCTGTTGTAAGT-CAAGAACGTGT--GTGAGA--G-T-GGAAAGTTCAC-ACA-GTGACGGTAGCTTAC-CAGAAAGGGACGGCTAACTACGTG
Firmicutes_-TTCAGTGTTGCGAGTGGTAGTTCACACTTCG-	----------------------------ATAGCTCACCAAGGCGACGATACATAGCCGACCTGAGAGGGTGATCGGCCACACTGGGACTGAGACACGGCCCAGACTCCTACGGGAGGCAGCAGTAGGGAATCTTCGGCAATGGACGGAAGTCTGACCGAGCAACGCCGCGTGAGTGAAGAAGGTT-TT-CGGA-TCGTAAAGCTCTGTTGTAAGA-GAAGAACGAGT--GTGAGA--G-T-GGAAAGTTCAC-ACT-GTGACGGTATCTTAC-CAGAAAGGGACGGCTAACTACGTG
Firmicutes_-TTTAGTATCACGAAGGTGAGAACTTAGCTCC-	----------------------------ATGGCTTACCAAGGTGACGATGCGTAGCCGAACTGAGAGGTTGATCGGCCACATTGGGACTGAGACACGGCCCAAACTCCTACGGGAGACAGCAGTTAGGAATATTCGTCAATGGAGGAAACTCTGAACGAGCAATGCCGCGTGAGTGATGAAGGTC-TTATAGA-TTGTAAAACTCTGTTGTATGG-AAAAAACGACT--AGGTTA--G-G-AAA-TGAACTT-AGT-GTGATGGTACCATAC-CAGAAAGCCCCGGCTAACTACGTG
Firmicutes_AACCAGAACTG--------A--------CGCC-	--CGTCCGATTAGCTAGTTGGTGAGGTAAAGGCCCACCAAGGCGACGATCGGTAGCCGGCCTGAGAGGGTGAACGGCCACATTGGGACTGAGACACGGCCCAAACTCCTACGGGAGGCAGCAGTGGGGAATATTGGACAATGGGGGAAACCCTGATCCAGCGACGCCGCGTGAGTGAAGAAGTAT-TT-CGGT-ATGTAAAGCTCTATCAGCAGG-GAAGA--------------------AAA--------------TGACGGTACCTGAC-TAAGAAGCCCCGGCTAACTACGTG
Firmicutes_AACTAAAACTG--------A--------TTGC-	--CGTCTGATTAGCTAGTTGGAAGGGTAAAGGCCTACCAAGGCAACGATCAGTAGCCGGTCTGAGAGGATGAACGGCCACACTGGAACTGAGACACGGTCCAGACTCCTACGGGAGGCAGCAGTGGGGAATATTGCACAATGGGGGAAACCCTGATGCAGCGACGCCGCGTGAGCGAAGAAGGTT-TT-CGAA-TCGTAAAGCTCTGTCCTATGA-GAAGA--------------------TAA--------------TGACGGTATCATAG-GAGGAAGCCCCGGCTAAATACGTG
Firmicutes_AACTAAAATTG--------A--------CGCC-	--CGTCCGATTAGCCAGTTGGCAGGGTAAAAGCCTACCAAAGCAACGATCGGTAGCCGGACTGAGAGGTCGGACGGCCACATTGGGACTGAGACACGGCCCAAACTCCTACGGGAGGCAGCAGTGGGGGATATTGCACAATGGAGGAAACTCTGATGCAGCGACGCCGCGTGAGTGAAGAAGTAT-TT-CGGT-ATGTAAAGCTCTATCAGCAGG-GAAGA--------------------TGA--------------TGACGGTACCTGAC-TAAGAAGCCCCGGCTAACTACGTG
Firmicutes_AACTAACACTG--------A--------CGCC-	--CGTCTGATTAGCCAGTTGGCAGGGTAAAAGCCTACCAAAGCAACGATCAGTAGCCGATCTGAGAGGATGACCGGCCACATTGGGACTGAGACACGGCCCAAACTCCTACGGGAGGCAGCAGTGGGGAATATTGCACAATGGGGGAAACCCTGATGCAGCGACGCCGCGTGAGTGAAGAAGTAT-TT-CGGT-ATGTAAAGCTCTATCAGCAGG-GAAGA--------------------TAA--------------TGACAGTACCTGAC-TAAGAAGCCCCGGCTAACTACGTG
Firmicutes_AACTAGAACTG--------A--------TTGC-	--CGTCTGATTAGCTAGTTGGAAGGGTAAAGGCCTACCAAGGCGACGATCAGTAGCCGGTCTGAGAGGATGAACGGCCACACTGGAACTGAGACACGGTCCAGACTCCTACGGGAGGCAGCAGTGGGGAATATTGCACAATGGGGGAAACCCTGATGCAGCGACGCCGCGTGAGCGAAGAAGGTT-TT-CGAA-TCGTAAAGCTCTGTCCTATGA-GAAGA--------------------TAA--------------TGACGGTATCATAG-GAGGAAGCCCCGGCTAAATACGTG
Firmicutes_AACTAGAATTG--------A--------CGCC-	--CGTCCGATTAGCCAGTTGGCAGGGTAAAAGCCTACCAAAGCGACGATCGGTAGCCGGACTGAGAGGTCGGACGGCCACATTGGGACTGAGACACGGCCCAAACTCCTACGGGAGGCAGCAGTGGGGGATATTGCACAATGGAGGAAACTCTGATGCAGCGACGCCGCGTGAGTGAAGAAGTAT-TT-CGGT-ATGTAAAGCTCTATCAGCAGG-GAAGA--------------------TGA--------------TGACGGTACCTGAC-TAAGAAGCCCCGGCTAACTACGTG
Firmicutes_AACTAGAATTG-------G---------CTTC-	--CGGAAGATTAGGTAGTTGGTGGGGTAAAGGCCTACCAAGCCGACGATCTATAGCTGGTCTGAGAGGACGAACAGCCACATTGGAACTGAGACACGGTCCAGACTCCTACGGGAGGCAGCAGTGAGGAATATTGGGCAATGGAGGAAACTCTGACCCAGCCATGCCGCGTGAGTGAAGAAGGTT-TT-CGAA-TTGTAAAGCTCTTTCGGATGG-GACGAT-----------------G-A----------------TGACGGTACCATCT-AAAGAAGCCCCGGCAAACTTCGTG
Firmicutes_AACTAGAGCTG--------A--------TTGC-	--CGTCTGATTAGCTAGTTGGAAGGGTAAAGGCCTACCAAGGCGACGATCAGTAGCCGGTCTGAGAGGATGAACGGCCACATTGGAACTGAGACACGGTCCAAACTCCTACGGGAGGCAGCAGTGGGGAATATTGCACAATGGGGGGAACCCTGATGCAGCGACGCCGCGTGAGCGAAGAAGGTT-TT-CGAA-TCGTAAAGCTCTGTCCTATGA-GAAGA--------------------TAA--------------TGACGGTATCATAG-GAGGAAGCCCCGGCTAAATACGTG
Firmicutes_AACTAGCACTG--------A--------CGCC-	--CGTCTGATTAGCCAGTTGGCAGGGTAAAAGCCTACCAAAGCGACGATCAGTAGCCGATCTGAGAGGATGACCGGCCACATTGGGACTGAGACACGGCCCAAACTCCTACGGGAGGCAGCAGTGGGGAATATTGCACAATGGGGGAAACCCTGATGCAGCGACGCCGCGTGAGTGAAGAAGTAT-TT-CGGT-ATGTAAAGCTCTATCAGCAGG-GAAGA--------------------TAA--------------TGACAGTACCTGAC-TAAGAAGCCCCGGCTAACTACGTG
Firmicutes_AACTAGTGCTG--------A--------CGCC-	--CGTCTGATTAGCTAGTTGGTGGGGTAAAGGCCTACCAAGGCGACGATCAGTAGCCGACCTGAGAGGGTGATCGGCCACATTGGGACTGAGACACGGCCCAAACTCCTACGGGAGGCAGCAGTGGGGAATATTGGACAATGGGGGGAACCCTGATCCAGCGACGCCGCGTGAGTGAAGAAGTAT-TT-CGGT-ATGTAAAGCTCTATCAGCAGG-GAAGA--------------------AAA--------------TGACGGTACCTGAC-TAAGAAGCCCCGGCTAACTACGTG
Firmicutes_AATCAGAACTG--------A--------CGCC-	--CGTCCGATTAGCTAGTTGGTGAGGTAGAGGCTCACCAAGGCGACGATCGGTAGCCGGCCTGAGAGGGTGAACGGCCACATTGGGACTGAGACACGGCCCAAACTCCTACGGGAGGCAGCAGTGGGGAATATTGGACAATGGGGGAAACCCTGATCCAGCGACGCCGCGTGAGTGAAGAAGTAT-TT-CGGT-ATGTAAAGCTCTATCAGCAGG-GAAGA--------------------AAA--------------TGACGGTACCTGAC-TAAGAAGCCCCGGCTAACTACGTG
Firmicutes_AATCAGCCCTGAAT----GA----------AC-	----TCTGATTAGGTAGTTGGTGAGGTAGAGGCTCACCAAGCCGACGATCGGTAGCCGATCTGAGAGGATGACCGGCCACATTGGGACTGAGACACGGCCCAAACTCCTACGGGAGGCAGCAGTGGGGAATATTGGACAATGGGGGCAACCCTGATCCAGCGACGCCGCGTGAGTGAAGAAGTAT-TT-CGGT-ATGTAAAGCTCTATCGATAACGGAAGAAAAT--------------G-ACA--------------AGCCGTTA-----AGGAAGAAGCCCCGGCTAACTACGTG
Firmicutes_AATCAGCCCTGGAT----GA----------AC-	----TCTGATTAGGTAGTTGGTGAGGTAGAGGCTCACCAAGCCGACGATCGGTAGCCGATCTGAGAGGATGACCGGCCACATTGGGACTGAGACACGGCCCAAACTCCTACGGGAGGCAGCAGTGGGGAATATTGGACAATGGGGGCAACCCTGATCCAGCGACGCCGCGTGAGTGAAGAAGTAT-TT-CGGT-ATGTAAAGCTCTATCGATAACGGAAGAAGAT--------------G-ACA--------------AGCCGTTA-----AGGAAGAAGCCCCGGCTAACTACGTG
Firmicutes_ACCCAAAACCG--------A--------CACG-	--CGTCCGATTAGCTAGTTGGTGAGGTAACGGCCCACCAAGGCAACGATCGGTAGCCGGACTGAGAGGTTGAACGGCCACATTGGGACTGAGACACGGCCCAGACTCCTACGGGAGGCAGCAGTGGGGAATATTGCACAATGGGGGAAACCCTGATGCAGCGACGCCGCGTGGAGGAAGAAGGTC-TT-CGGA-TTGTAAACTCCTGTTGTTGAG-GAAGA--------------------TAA--------------TGACGGTACTCAAC-AAGGAAGTGACGGCTAACTACGTG
Firmicutes_ACCCAGAACCG--------A--------CACG-	--CGTCCGATTAGCTAGTTGGTGAGGTAACGGCCCACCAAGGCGACGATCGGTAGCCGGACTGAGAGGTTGAACGGCCACATTGGGACTGAGACACGGCCCAGACTCCTACGGGAGGCAGCAGTGGGGAATATTGCACAATGGGGGAAACCCTGATGCAGCGACGCCGCGTGGAGGAAGAAGGTC-TT-CGGA-TTGTAAACTCCTGTTGTTGAG-GAAGA--------------------TAA--------------TGACGGTACTCAAC-AAGGAAGTGACGGCTAACTACGTG
Firmicutes_ACCCAGAACTG--------A--------CACA-	--CGTCCAATTAGCTAGTTGGTGAGGTAACGGCCCACCAAGGCGACGATTGGTAGCCGGACTGAGAGGTTGAACGGCCACATTGGGACTGAGACACGGCCCAGACTCCTACGGGAGGCAGCAGTGGGGGATATTGCACAATGGGGGAAACCCTGATGCAGCGACGCCGCGTGGAGGAAGAAGGTT-TT-CGGA-TTGTAAACTCCTGTCGTTAGG-GACGA--------------------TAA--------------TGACGGTACCTAAC-AAGAAAGCACCGGCTAACTACGTG
Firmicutes_ACCCAGAACTG--------A--------CGCA-	--CGTCTGATTAGCTAGTTGGTGAGGTAACGGCCCACCAAGGCGACGATCAGTAGCCGGCCTGAGAGGGTGAACGGCCACATTGGGACTGAGACACGGCCCAAACTCCTACGGGAGGCAGCAGTGGGGAATATTGCACAATGGGGGAAACCCTGATGCAGCGACGCCGCGTGAGTGATGAAGTAT-TT-CGGT-ATGTAAAGCTCTATCAGCAGG-GAAGA--------------------TAA--------------TGACGGTACCTGAC-TAAGAAGCACCGGCTAAATACGTG
Firmicutes_ACCCAGAACTG--------G--------CGAC-	--CGTCTGATTAGCCAGTTGGCGGGGTAACGGCCCACCAAAGCGACGATCAGTAGCCGGCCTGAGAGGGTGAACGGCCACATTGGGACTGAGACACGGCCCAAACTCCTACGGGAGGCAGCAGTGGGGAATATTGCACAATGGGGGAAACCCTGATGCAGCGACGCCGCGTGAGTGAAGAAGTAT-TT-CGGT-ATGTAAAGCTCTATCAGCAGG-GAAGA--------------------AAG--------------TGACGGTACCTGAA-TAAGAAGCCCCGGCTAACTACGTG
Firmicutes_ACCCAGACCTG--G----TA--------CGCC-	----TCTGATTAGCTAGTTGGTGAGGTAACGGCCCACCAAGGCGACGATCAGTAGCCGGACTGAGAGGTTGAACGGCCACATTGGGACTGAGATACGGCCCAGACTCCTACGGGAGGCAGCAGTGGGGAATATTGGGCAATGGGCGCAAGCCTGACCCAGCAACGCCGCGTGAAGGAAGAAGGCT-TT-CGGG-TTGTAAACTTCTTTTGTCAGG-GACGA---G--------------T-AGA--------------AGACGGTACCTGAC-GAATAAGCCACGGCTAACTACGTG
Firmicutes_ACCCAGACCTG-GC-----A--------CCAC-	----TCTGATTAGCTAGTTGGCGGGGTAACGGCCCACCAAGGCGACGATCAGTAGCCGGACTGAGAGGTTGAACGGCCACATTGGGACTGAGATACGGCCCAGACTCCTACGGGAGGCAGCAGTGGGGAATATTGGGCAATGGGCGCAAGCCTGACCCAGCAACGCCGCGTGAAGGAAGAAGGCT-TT-CGGG-TTGTAAACTTCTTTTAAGAGG-GAAGA--GC----------------AGA--------------AGACGGTACCTCTA-GAATAAGCCACGGCTAACTACGTG
Firmicutes_ACCCAGCACCG--------A--------CGGC-	--CGTTCGATTAGCCAGTTGGCGGGGTAACGGCCCACCAAAGCGACGATCGATAGCCGATCTGAGAGGATGACCGGCCACATTGGGACTGAGACACGGCCCAAACTCCTACGGGAGGCAGCAGTGGGGAATATTGCACAATGGGGGAAACCCTGATGCAGCGACGCCGCGTGAGTGAAGAAGTAC-TT-CGGT-ATGTAAAGCTCTATCAGCAGG-GAAGA--------------------AAA--------------TGACGGTACCTGAG-TAAGAAGCCCCGGCTAACTACGTG
Firmicutes_ACCCAGCACTG--------A--------CGCA-	--CGTTGGATTAGCTAGTTGGTGAGGTAACGGCCCACCAAGGCGACGATCCATAGCCGACCTGAGAGGGTGACCGGCCACATTGGGACTGAGACACGGCCCAAACTCCTACGGGAGGCAGCAGTGGGGAATATTGCACAATGGGCGAAAGCCTGATGCAGCGACGCCGCGTGAGCGAAGAAGTAT-TT-CGGT-ATGTAAAGCTCTATCAGCAGG-GAAGA--------------------TAA--------------TGACGGTACCTGAC-TAAGAAGCACCGGCTAAATACGTG
Firmicutes_ACCCAGCACTG--------A--------CGGC-	--CGTTCGATTAGCCAGTTGGCGGGGTAACGGCCCACCAAAGCGACGATCGATAGCCGATCTGAGAGGATGACCGGCCACATTGGGACTGAGACACGGCCCAAACTCCTACGGGAGGCAGCAGTGGGGAATATTGCACAATGGGGGAAACCCTGATGCAGCGACGCCGCGTGAGTGAAGAAGTAT-TT-CGGT-ATGTAAAGCTCTATCAGCAGG-GAAGA--------------------AAA--------------TGACGGTACCTGAG-TAAGAAGCCCCGGCTAACTACGTG
Firmicutes_ACCCAGCATAG--------G--------CGCT-	--CGTCTGATTAGCTAGTTGGTGAGATAACAGCCCACCAAGGCGACGATCAGTAGCCGACCTGAGAGGGTGACCGGCCACATTGGGACTGAGACACGGCCCAGACTCCTACGGGAGGCAGCAGTGGGGAATATTGCACAATGGAGGAAACTCTGATGCAGCGACGCCGCGTGAGTGAAGAAGTAA-TT-CGTT-ATGTAAAGCTCTATCAGCAGG-GAAGA--------------------TAG--------------TGACGGTACCTGAC-TAAGAAGCTCCGGCTAAATACGTG
Firmicutes_ACCCAGCATTG--------G--------CGCT-	--CGTCTGATTAGGTAGTTGGTGAGGTAACGGCCCACCAAGCCGACGATCAGTAGCCGACCTGAGAGGGTGACCGGCCACATTGGGACTGAGACACGGCCCAGACTCCTACGGGAGGCAGCAGTGGGGAATATTGCACAATGGAGGAAACTCTGATGCAGCGACGCCGCGTGAGTGAAGAAGTAT-TT-CGGT-ATGTAAAGCTCTATCAGCAGG-GAAGA--------------------CAG--------------TGACGGTACCTGAC-TAAGAAGCTCCGGCTAAATACGTG
Firmicutes_ACCCAGCCCTG--G----TA--------CCTC-	----TCTGATTAGATAGTTGGCGGGGTAACGGCCCACCAAGTCGACGATCAGTAGCCGGACTGAGAGGTTGACCGGCCACATTGGGACTGAGATACGGCCCAGACTCCTACGGGAGGCAGCAGTGGGGAATATTGGGCAATGGGCGCAAGCCTGACCCAGCAACGCCGCGTGAAGGAAGAAGGCT-TT-CGGG-TTGTAAACTTCTTTTAAGTGG-GAAGA---G--------------T-AGA--------------AGACGGTACCACTT-GAATAAGCCACGGCTAACTACGTG
Firmicutes_ACCCAGCCCTG--G----TA--------CGCC-	----TCTGATTAGCTAGTTGGTGAGGTAACGGCCCACCAAGGCGACGATCAGTAGCCGGACTGAGAGGTTGACCGGCCACATTGGGACTGAGATACGGCCCAGACTCCTACGGGAGGCAGCAGTGGGGAATATTGGGCAATGGGCGCAAGCCTGACCCAGCAACGCCGCGTGAAGGAAGAAGGCT-TT-CGGG-TTGTAAACTTCTTTTGTCGGG-GACGA---G--------------T-AGA--------------AGACGGTACCTGGC-GAATAAGCCACGGCTAACTACGTG
Firmicutes_ACCCAGCCTTG--G----TA--------CGCC-	----TCTGATTAGCTAGATGGTGGGGTAACGGCCCACCATGGCGACGATCAGTAGCCGGACTGAGAGGTTGACCGGCCACATTGGGACTGAGATACGGCCCAGACTCCTACGGGAGGCAGCAGTGGGGAATATTGGGCAATGGACGCAAGTCTGACCCAGCAACGCCGCGTGAAGGAAGAAGGCT-TT-CGGG-TTGTAAACTTCTTTTGTCAGG-GAAGA---G--------------T-AGA--------------AGACGGTACCTGAC-GAATAAGCCACGGCTAACTACGTG
Firmicutes_ACCCAGTACCG--------A--------CTTC-	--CGTCTGATTAGCTAGTTGGTGAGATAACTGCCCACCAAGGCGACGATCAGTAGCCGACCTGAGAGGGTGATCGGCCACATTGGAACTGAGACACGGTCCAAACTCCTACGGGAGGCAGCAGTGGGGAATATTGCACAATGGGCGAAAGCCTGATGCAGCAACGCCGCGTGAACGATGAAGGTC-TT-CGGA-TCGTAAAGTTCTGTTGCAGGG-GAAGA--------------------TAA--------------TGACGGTACCCTGT-GAGGAAGCCCCGGCTAACTACGTG
Firmicutes_ACCCAGTATTG--G----TA--------TAGC-	----TCCGATTAGGTAGTTGGTGAGGTAACGGCCCACCAAGCCGACGATCGGTAGCCGACCTGAGAGGGTGATCGGCCACATTGGGACTGAGACACGGCCCAAACTCCTACGGGAGGCAGCAGTGGGGAATATTGGGCAATGGAGGAAACTCTGACCCAGCAACGCCGCGTGGAGGAAGAAGGTT-TT-CGGA-TCGTAAACTCCTGTCCTTGGA-GACGA---G--------------T-AGA--------------AGACGGTATCCAAG-GAGGAAGCCCCGGCTAACTACGTG
Firmicutes_ACCCAGTGTTG--G----TA--------TAGC-	----TCCGATTAGGTAGTTGGTGAGGTAACGGCCCACCAAGCCGACGATCGGTAGCCGACCTGAGAGGGTGATCGGCCACATTGGGACTGAGACACGGCCCAAACTCCTACGGGAGGCAGCAGTGGGGAATATTGGGCAATGGAGGGAACTCTGACCCAGCAACGCCGCGTGGAGGAAGAAGGTT-TT-CGGA-TCGTAAACTCCTGTCCTTGGA-GACGA---G--------------T-AGA--------------AGACGGTATCCAAG-GAGGAAGCCCCGGCTAACTACGTG
Firmicutes_ACCTAGAACCG--------C--------CGGC-	----TCCGATTAGATAGTTGGTGGGGTAACGGCCTACCAAGTCGACGATCGGTAGCCGGACTGAGAGGTCGAACGGCCACATTGGGACTGAGACACGGCCCAGACTCCTACGGGAGGCAGCAGTGGGGGATATTGCACAATGGGGGAAACCCTGATGCAGCGACGCCGCGTGAGGGAAGACGGTCCTC-TGGA-TTGTAAACCTCTGTCTTCGGG-GACGA--------------------AAC-G------------AGACGGTACCCGAG-GAGGAAGCCACGGCTAACTACGTG
Firmicutes_ACCTAGAACTG--------A--------CGCC-	--CGTCTGATTAGCTAGTTGGTGGGGTAACGGCCTACCAAGGCGACGATCAGTAGCCGGCCTGAGAGGGTGAACGGCCACATTGGGACTGAGACACGGCCCAAACTCCTACGGGAGGCAGCAGTGGGGAATATTGGACAATGGGCGAAAGCCTGATCCAGCGACGCCGCGTGAGCGATGAAGTAT-TT-CGGT-ATGTAAAGCTCTATCAGCAGG-GAAGA--------------------AAA--------------CGACGGTACCTGAC-TAAGAAGCCCCGGCTAACTACGTG
Firmicutes_ACCTAGCACTG--------A--------CGCA-	---GTCTGATTAGCCAGTTGGCAGGGTAACGGCCTACCAAAGCGACGATCAGTAGCCGACCTGAGAGGGTGACCGGCCACATTGGGACTGAGACACGGCCCAAACTCCTACGGGAGGCAGCAGTGGGGAATATTGCACAATGGGGGAAACCCTGATGCAGCGACGCCGCGTGAGCGAAGAAGTAT-TT-CGGT-ATGTAAAGCTCTATCAGCAGG-GAAGAA-------------------GAA--------------TGACGGTACCTGAC-TAAGAAGCACCGGCTAAATACGTG
Firmicutes_ACCTAGCACTG--------A--------CGCC-	--CGTCTGATTAGGTAGTTGGTGGGGTAACGGCCTACCAAGCCGACGATCAGTAGCCGACCTGAGAGGGTGACCGGCCACATTGGGACTGAGACACGGCCCAAACTCCTACGGGAGGCAGCAGTGGGGAATATTGCACAATGGGGGAAACCCTGATGCAGCGACGCCGCGTGAGCGATGAAGTAT-TT-CGGT-ATGTAAAGCTCTATCAGCAGG-GAAGA--------------------AAA--------------TGACGGTACCTGAC-TAAGAAGCCCCGGCTAACTACGTG
Firmicutes_ACCTAGCACTG-------GA--------CGCA-	----TCTGATTAGCTAGTTGGCAGGGCAACGGCCTACCAAGGCGACGATCAGTAGCCGACCTGAGAGGGTGACCGGCCACATTGGGACTGAGACACGGCCCAAACTCCTACGGGAGGCAGCAGTGGGGAATATTGCACAATGGGGGAAACCCTGATGCAGCGACGCCGCGTGAGCGAAGAAGTAT-TT-CGGT-ATGTAAAGCTCTATCAGCAGG-GAAGAA-----------------G-AAA--------------TGACGGTACCTGAC-TAAGAAGCACCGGCTAAATACGTG
Firmicutes_ACTCAAAATCG--------A--------TCGC-	TGCGTCTGATTAGCTAGTTGGTGAGATAACAGCTCACCAAGGCAACGATCAGTAGCCGGATTGAGAGGTTGAACGGCCACATTGGGACTGAGACACGGCCCAGACTCCTACGGGAGGCAGCAGTCGGGAATATTGCACAATGGAGGAAACTCTGATGCAGTGACACCGCGTATAGGAAGAAGGTC-TT-AGGA-TTGTAAGCTATTGTCGTGTGA-GAAGA--------------------AAA--------------TGACC--ATCACAG-GAGGAAGCCCTGGCTAAATATGTG
Firmicutes_ACTCACAACCG-------GA--------CATT-	-----CCGATTAGTTAGTTGGTGAGGTAACGGCTCACCAAGACCGCGATCGGTAGCCGGACTGAGAGGTTGAACGGCCACATTGGGACTGAGACACGGCCCAGACTCCTACGGGAGGCAGCAGTGGGGGATATTGCGCAATGGGGGAAACCCTGACGCAGCAACGCCGCGTGAAGGATGAAGGTC-TT-CGGA-TTGTAAACTTCTTTTATTAAG-GACGAA-----------------G-AAA-G------------TGACGGTACTTAAT-GAATAAGCTCCGGCTAACTACGTG
Firmicutes_ACTCACACCTG--------A--------CATT-	---GTCCGATTAGTTAGTTGGTGAGGTAACGGCTCACCAAGACCGCGATCGGTAGCCGGACTGAGAGGTTGAACGGCCACATTGGGACTGAGACACGGCCCAGACTCCTACGGGAGGCAGCAGTGGGGGATATTGCGCAATGGGGGCAACCCTGACGCAGCAACGCCGCGTGAAGGATGAAGGTT-TT-CGGA-TTGTAAACTTCTTTTATTAAG-GACGAA-------------------AAA--------------TGACGGTACTTAAT-GAATAAGCTCCGGCTAACTACGTG
Firmicutes_ACTCACACCTG--------C--------CATT-	---GTCCGATTAGTTAGTTGGTGAGGTAACGGCTCACCAAGACCGCGATCGGTAGCCGGACTGAGAGGTTGAACGGCCACATTGGGACTGAGACACGGCCCAGACTCCTACGGGAGGCAGCAGTGGGGGATATTGCGCAATGGGGGCAACCCTGACGCAGCAACGCCGCGTGAAGGATGAAGGTT-TT-CGGA-TTGTAAACTTCTTTTATTAAG-GACGA--------------------AAC-T------------TGACGGTACTTAAT-GAATAAGCTCCGGCTAACTACGTG
Firmicutes_ACTCAGAACCG--------A--------ATGC-	---GTCTGATTAGCTAGTTGGTGAGGTAACGGCTCACCAAGGCGACGATCAGTAGCCGACCTGAGAGGGTGAACGGCCACATTGGAACTGAGACACGGTCCAAACTCCTACGGGAGGCAGCAGTGGGGAATATTGCACAATGGGGGAAACCCTGATGCAGCAACGCCGCGTGAACGATGAAGGCC-TT-TGGG-TCGTAAAGTTCTGTTCTAGGT-GATGA--------------------AAA-C------------TGACAGTAACCTAG-GAGAAAGCCCCGGCTAACTCCGTG
Firmicutes_ACTCAGAACTG-------CA--------AGGC-	----TCCGATTAGATAGTTGGTGAGGTAACGGCTCACCAAGTCGACGATCGGTAGCCGGACTGAGAGGTTGAACGGCCACATTGGGACTGAGACACGGCCCAGACTCCTACGGGAGGCAGCAGTGGGGAATATTGCACAATGGGCGAAAGCCTGATGCAGCAACGCCGCGTGAGGGAAGACGGTT-TT-CGGA-TTGTAAACCTCTGTTTTCGGT-GACGAA-----------------C-AAA--------------TGACGGTAACCGAG-TAGGAAGCCACGGCTAACTACGTG
Firmicutes_ACTCAGAACTG-------TA--------AGGC-	----TCCGATTAGATAGTTGGTGAGGTAACGGCTCACCAAGTCGACGATCGGTAGCCGGACTGAGAGGTTGAACGGCCACATTGGGACTGAGACACGGCCCAGACTCCTACGGGAGGCAGCAGTGGGGAATATTGCACAATGGGCGAAAGCCTGATGCAGCAACGCCGCGTGAGGGAAGACGGTT-TT-CGGA-TTGTAAACCTCTGTTTTCGGT-GACGAA-----------------T-AAA--------------TGACGGTAACCGAG-TAGGAAGCCACGGCTAACTACGTG
Firmicutes_ACTCAGAATCG--------A--------TCGC-	TGCGTCTGATTAGCTAGTTGGTGAGATAACAGCTCACCAAGGCGACGATCAGTAGCCGGATTGAGAGGTTGAACGGCCACATTGGGACTGAGACACGGCCCAGACTCCTACGGGAGGCAGCAGTCGGGAATATTGCACAATGGAGGAAACTCTGATGCAGTGACACCGCGTATAGGAAGAAGGTC-TT-AGGA-TTGTAAGCTATTGTCGTGTGA-GAAGA--------------------AAA--------------TGACC--ATCACAG-GAGGAAGCCCTGGCTAAATATGTG
Firmicutes_ACTCAGTACCG-AC-----A--------CTGC-	-----CTGATTAACTAGTTGGTGAGGTAACGGCTCACCAAGGTGACGATCAGTAGCCGACCTGAGAGGGTGATCGGCCACATTGGAACTGAGACACGGTCCAAACTTCTACGGAAGGCAGCAGTAGGGAATCTTGCACAATGGGCGAAAGCCTGATGCAGCAACGCCGCGTGAAGGATGAAGGCC-TT-CGGG-TTGTAAACTTCTGTTCTAAGG-GAAGAA-AC----------------AAA--------------TGACGGTACCTTAG-GAGCAAGCCCCGGCTAACTACGTG
Firmicutes_ACTTAATCCCG-AC-----A--------CTGC-	-----CTGATTAGCTAGTTGGTAGGGTAACGGCTTACCAAGGCAACGATCAGTAGCCGACCTGAGAGGGTGATCGGCCACATTGGAACTGAGACACGGTCCAAACTCCTACGGGAGGCAGCAGTGGGGAATATTGCACAATGGGCGCAAGCCTGATGCAGCAACGCCGCGTGAAGGATGAAGGCC-TT-CGGG-TTGTAAACTTCTGTCCTAGGG-GAAGAA-AC----------------AAA--------------TGACATTACCCTTG-GAGGAAGCCCCGGCTAACTACGTG
Firmicutes_ACTTAGCACTG--------A--------CGCA-	--CGTCTGATTAGCTAGTTGGTAAGGTAACGGCTTACCAAGGCGACGATCAGTAGCCGACCTGAGAGGGTGACCGGCCACATTGGGACTGAGACACGGCCCAAACTCCTACGGGAGGCAGCAGTGGGGAATATTGCACAATGGGGGAAACCCTGATGCAGCGACGCCGCGTGAGCGAAGAAGTAT-TT-CGGT-ATGTAAAGCTCTATCAGCAGG-GAAGA--------------------AAA--------------TGACGGTACCTGAC-TAAGAAGCACCGGCTAAATACGTG
Firmicutes_ACTTAGTATTG--------A--------CGGT-	---GTCTGATTAGCTAGTTGGTAAGGTAACGGCTTACCAAGGCGACGATCAGTAGCCGGACTGAGAGGTTGATCGGCCACATTGGGACTGAGACACGGCCCAGACTCCTACGGGAGGCAGCAGTGGGGAATATTGCACAATGGAGGAAACTCTGATGCAGCGATGCCGCGTGAGGGAAGAAGGTT-TT-AGGA-TTGTAAACCTCTGTCTTCAGG-GACGAA-------------------AAA--------------AGACGGTACCTGAG-GAGGAAGCTCCGGCTAACTACGTG
Firmicutes_ATCCAAAACCG--------A--------CACG-	--CGTCCGATTAGCTAGTTGGTGAGGTAATGGCCCACCAAGGCAACGATCGGTAGCCGGACTGAGAGGTTGAACGGCCACATTGGGACTGAGACACGGCCCAGACTCCTACGGGAGGCAGCAGTGGGGAATATTGCACAATGGGGGAAACCCTGATGCAGCGACGCCGCGTGGAGGAAGAAGGTC-TT-CGGA-TTGTAAACTCCTGTTGTTGAG-GAAGA--------------------TAA--------------TGACGGTACTCAAC-AAGGAAGTGACGGCTAACTACGTG
Firmicutes_ATCCAGAACCG--------A--------CACG-	--CGTCCGATTAGCTAGTTGGTGAGGTAATGGCCCACCAAGGCGACGATCGGTAGCCGGACTGAGAGGTTGAACGGCCACATTGGGACTGAGACACGGCCCAGACTCCTACGGGAGGCAGCAGTGGGGAATATTGCACAATGGGGGAAACCCTGATGCAGCGACGCCGCGTGGAGGAAGAAGGTC-TT-CGGA-TTGTAAACTCCTGTTGTTGAG-GAAGA--------------------TAA--------------TGACGGTACTCAAC-AAGGAAGTGACGGCTAACTACGTG
Firmicutes_GATCAGAACTG--------A--------CGCC-	--CGTCCGATTAGCTGGTTGGTGAGGTAGAGGCTCACCAAGGCGACGATCGGTAGCCGGCCTGAGAGGGTGAACGGCCACATTGGGACTGAGACACGGCCCAAACTCCTACGGGAGGCAGCAGTGGGGAATATTGGACAATGGGGGAAACCCTGATCCAGCGACGCCGCGTGAGTGAAGAAGTAT-TT-CGGT-ATGTAAAGCTCTATCAGCAGG-GAAGA--------------------AAA--------------TGACGGTACCTGAC-TAAGAAGCCCCGGCTAACTACGTG
Firmicutes_GCCCAGAACTA--------A--------CGCC-	--CGTCTGATTAGCTGGTTGGTGAGGTAACGGCCCACCAAGGCGACGATCAGTAGCCGGCCTGAGAGGGTGAACGGCCACATTGGGACTGAGACACGGCCCAAACTCCTACGGGAGGCAGCAGTGGGGAATATTGCACAATGGGGGAAACCCTGATGCAGCAACGCCGCGTGAGTGAAGAAGTAT-TT-CGGT-ATGTAAAGCTCTATCAGCAGG-AAAGA--------------------AAA--------------TGACGGTACCTGAC-TAAGAAGCCCCGGCTAACTACGTG
Firmicutes_GCCCAGACCTG-GC-----A--------CCAC-	----TCTGATTAGCTGGTTGGCGGGGTAACGGCCCACCAAGGCGACGATCAGTAGCCGGACTGAGAGGTTGAACGGCCACATTGGGACTGAGATACGGCCCAGACTCCTACGGGAGGCAGCAGTGGGGAATATTGGGCAATGGGCGCAAGCCTGACCCAGCAACGCCGCGTGAAGGAAGAAGGCT-TT-CGGG-TTGTAAACTTCTTTTAAGAGG-GAAGA--GC----------------AGA--------------AGACGGTACCTCTA-GAATAAGCCACGGCTAACTACGTG
Firmicutes_TATCAGAACTG--------A--------CGCC-	--CGTCCGATTAGCTTGTTGGTGAGGTAGAGGCTCACCAAGGCGACGATCGGTAGCCGGCCTGAGAGGGTGAACGGCCACATTGGGACTGAGACACGGCCCAAACTCCTACGGGAGGCAGCAGTGGGGAATATTGGACAATGGGGGAAACCCTGATCCAGCGACGCCGCGTGAGTGAAGAAGTAT-TT-CGGT-ATGTAAAGCTCTATCAGCAGG-GAAGA--------------------AAA--------------TGACGGTACCTGAC-TAAGAAGCCCCGGCTAACTACGTG
Fusobacteria_AACGTAGACCAAT-AGAC	ATTAGCTAGTTGGTGGGGTAAAGGCCTACCAAGGCGATGATAGGTAGCCGGCCCGAGAGGGTGAACGGCCACAAGGGGACTGAGATACGGCCCTTACTCCTACGGGAGGCAGCAGTGGGGAATATTGGACAATGG-AG-GTAA-C-TCTGATCCAGCAATTCTGTGTGCACGAAGAAGGTTTTCGGATTGTAAAGTGCTTTCAGTAGGGAAGAA--G-AAAGTGACGGTACCTACAGAAGAAGCGACGGCTAAATACGTG
Fusobacteria_AATGTAGACTAACCAGAC	ATTAGCTAGTTGGTAAGGTAAAGGCTTACCAAGGCGATGATAGGTAGCCGGCCTGAGAGGGTGGACGGCCACAAGGGGACTGAGATACGGCCCTTACTCCTACGGGAGGCAGCAGTGGGGAATATTGGACAATGG-AG-GAAA-C-TCTGATCCAGCAATTCTGTGTGTGTGAAGAAGGTCTTCGGATTGTAAAACACTTTTAGTTGGGAAGAAAC--AAA-TGACGGTACCAACAGAAGAAGCGACGGCTAAATACGTG
Fusobacteria_ACCATAAAGCTCT-TGAC	-TTAGCTAGTTGGTGAGGTAACGGCCCACCAAGGCAATGATGGGTAGCCGGCCTGAGAGGGTGAACGGCCACAAGGGGACTGAGACACGGCCCTTACTCCTACGGGAGGCAGCAGTGGGGAATATTGGACAATGG-ACCACAA-G-TCTGATCCAGCAATTCTGTGTGCACGATGACGTTTTTCGGAATGTAAAGTGCTTTCAGTCGGGAAGAA--G-TCAGTGACGGTACCGACAGAAGAAGCGACGGCTAAATACGTG
Fusobacteria_ACCATGGACCTATAAGGC	ATTAGCTTGTTGGTGGGGTAACGGCCCACCAAGGCAATGATAGGTAGCCGGCCTGAGAGGGTGGACGGCCACAAGGGGACTGAGATACGGCCCTTACTCCTACGGGAGGCAGCAGTGGGGAATATTGGACAATGG-GG-GCAA-C-CCTGATCCAGCAATTCTGTGTGCACGATGAAGGTTTTCGGATTGTAAAGTGCTTTCAGCAGGGAAGAAAA--AAA-TGACGGTACCTGCAGAAGAAGCGACGGCTAAATACGTG
Fusobacteria_ACCGAGGACCACT-GGGC	ATTAGCTAGTTGGAGGGGTAACGGCCCACCAAGGCGAAGATAGGTAGCCGGCCTGAGAGGGTGGACGGCCACAAGGGGACTGAGATACGGCCCTTACTCCTACGGGAGGCAGCAGTGGGGAATATTGGACAATGG-GG-GCAA-C-CCTGATCCAGCAATTCTGTGTGCACGAAGACGGTTTTCGGATTGTAAAGTGCTTTCAGCAGGGAAGAA--G-GAAGTGACGGTACCTGCAGAAGAAGCGACGGCTAAATACGTG
Fusobacteria_ACCGAGGACCACT-TGGC	ATTAGCTAGTTGGAGGGGTAACGGCCCACCAAGGCGAAGATAGGTAGCCGGCCTGAGAGGGTGGACGGCCACAAGGGGACTGAGATACGGCCCTTACTCCTACGGGAGGCAGCAGTGGGGAATATTGGACAATGG-GG-GCAA-C-CCTGATCCAGCAATTCTGTGTGCACGAAGACGGTTTTCGGATTGTAAAGTGCTTTCAGCAGGGAAGAA--G-TAAGTGACGGTACCTGCAGAAGAAGCGACGGCTAAATACGTG
Fusobacteria_ACCGTAGACTAAT-AGGC	ATTAGTTAGTTGGTGGGGTAACGGCCTACCAAGGCGATGATAGGTAGCCGGCCTGAGAGGGTGGACGGCCACAAGGGGACTGAGATACGGCCCTTACTCTTACGGGAGGCAGCAGTGGGGAATATTGGACAATGG-AG-GTAA-C-TCTGATCCAGCAATTCTGTGTGCATGAAGAAGGTTTTCGGATTGTAAAGTGCTTTCAGCAGGGAAGAA--G-AAAGTGACGGTACCTGCAGAAGAAGCGACGGCTAAATACGTG
Fusobacteria_ACCGTGGACCAAT-AGGC	ATTAGCTAGTTGGTGGGGTAACGGCCCACCAAGGCGATGATAGGTAGCCGGCCTGAGAGGGTGAACGGCCACAAGGGGACTGAGATACGGCCCTTACTCCTACGGGAGGCAGCAGTGGGGAATATTGGACAATGG-GG-GCAA-C-CCTGATCCAGCAATTCTGTGTGCACGAAGAAGGTTTTCGGATTGTAAAGTGCTTTCAGCAGGGAAGAA--G-AAAGTGACGGTACCTGCAGAAGAAGCGACGGCTAAATACGTG
Fusobacteria_ACCGTGGACCTACAAGGC	ATTAGCTTGTTGGTGGGGTAACGGCCCACCAAGGCGATGATAGGTAGCCGGCCTGAGAGGGTGGACGGCCACAAGGGGACTGAGATACGGCCCTTACTCCTACGGGAGGCAGCAGTGGGGAATATTGGACAATGG-GG-GCAA-C-CCTGATCCAGCAATTCTGTGTGCACGATGAAGGTCTTCGGATTGTAAAGTGCTTTCAGCAGGGAAGAAAA--AAA-TGACGGTACCTGCAGAAGAAGCGACGGCTAAATACGTG
Fusobacteria_ACCGTGGACCTAT-GGGC	ATTAGCTTGTTGGCGGGGTAACGGCCCACCAAGGCGATGATAGGTAGCCGGCCTGAGAGGGTGAACGGCCACAAGGGGACTGAGATACGGCCCTTACTCCTACGGGAGGCAGCAGTGGGGAATATTGGACAATGG-GG-GCAA-C-CCTGATCCAGCAATTCTGTGTGCACGATGAAGGTTTTCGGATTGTAAAGTGCTTTCAGCAGGGAAGAA--G-GAAGTGACGGTACCTGCAGAAGAAGCGACGGCTAAATACGTG
Fusobacteria_ACCGTGGACCTATAAGGC	ATTAGCTTGTTGGTGGGGTAACGGCCCACCAAGGCGATGATAGGTAGCCGGCCTGAGAGGGTGGACGGCCACAAGGGGACTGAGATACGGCCCTTACTCCTACGGGAGGCAGCAGTGGGGAATATTGGACAATGG-GG-GCAA-C-CCTGATCCAGCAATTCTGTGTGCACGATGAAGGTTTTCGGATTGTAAAGTGCTTTCAGCAGGGAAGAAAA--AAA-TGACGGTACCTGCAGAAGAAGCGACGGCTAAATACGTG
Fusobacteria_ACCGTGGACTAAT-AGGC	ATTAGCTAGTTGGTGGGGTAACGGCCCACCAAGGCGATGATAGGTAGCCGGCCTGAGAGGGTGAACGGCCACAAGGGGACTGAGATACGGCCCTTACTCCTACGGGAGGCAGCAGTGGGGAATATTGGACAATGG-GG-GCAA-C-CCTGATCCAGCAATTCTGTGTGCATGAAGAAGGTTTTCGGATTGTAAAGTGCTTTCAGCAGGGAAGAA--G-AAAGTGACGGTACCTGCAGAAGAAGCGACGGCTAAATACGTG
Fusobacteria_ACTGAAGGCCACT-AGGC	ATTAGTTAGTTGGTGAGGTAACGGCTCACCAAGACGAAGATAGGTAGCCGGTCTGAGAGGATGAACGGCCACAAGGGGACTGAGATACGGCCCTTACTCTTACGGGAGGCAGCAGTGGGGAATATTGGACAATGG-AG-GAGA-C-TCTGATCCAGCAATTCTGTGTGCACGAAGACGGTTTTCGGATTGTAAAGTGCTTTCAGCAGGGAAGAA--G-AAAGTGACGGTACCTGCAGAAGAAGCGACGGCTAAATACGTG
Fusobacteria_ACTGAAGGCCACT-CGGC	ATTAGTTAGTTGGTGAGGTAACGGCTCACCAAGACGAAGATAGGTAGCCGGTCTGAGAGGATGAACGGCCACAAGGGGACTGAGATACGGCCCTTACTCTTACGGGAGGCAGCAGTGGGGAATATTGGACAATGG-AG-GAGA-C-TCTGATCCAGCAATTCTGTGTGCACGAAGACGGTTTTCGGATTGTAAAGTGCTTTCAGCAGGGAAGAA--G-CAAGTGACGGTACCTGCAGAAGAAGCGACGGCTAAATACGTG
Fusobacteria_ACTGAGGACCAAT-AGGC	ATTAGCTAGTTGGTTGGGTAACGGCTGACCAAGGCGAAGATAGGTAGCCGGCCTGAGAGGGTGGACGGCCACAAGGGGACTGAGATACGGCCCTTACTCCTACGGGAGGCAGCAGTGGGGAATATTGGACAATGG-GG-GCAA-C-CCTGATCCAGCAATTCTGTGTGCACGAAGAAGGTTTTCGGATTGTAAAGTGCTTTCAGCAGGGAAGAA--GGAAG-TGACGGTACCTGCAGAAGAAGCGACGGCTAAATACGTG
Fusobacteria_ACTGCGGACCAAT-CGGC	ATTAGCTTGTTGGTGAGGTAACGGCTCACCAAGGCGACGATAGGTAGCCGGCCTGAGAGGGTGAACGGCCACAAGGGGACTGAGATACGGCCCTTACTCCTACGGGAGGCAGCAGTGGGGAATATTGGACAATGG-GG-GCAA-C-CCTGATCCAGCAATTCTGTGTGCACGAAGAAGGCTTTCGGGCTGTAAAGTGCTTTCAGCAGGGAAGAA--G-CAAGTGACGGTACCTGCAGAAGAAGCGACGGCTAAATACGTG
Fusobacteria_ACTGTA-AACTATAAGAT	-TTAGCTAGTTGGAGAGGTAACGGCTCACCAAGGCGATGATGGGTAGCCGGCCTGAGAGGGTGATCGGCCACAAGGGGACTGAGACACGGCCCTTACTCCTACGGGAGGCAGCAGTGGGGAATATTGGACAATGG-AC--CAAGAGTCTGATCCAGCAATTCTGTGTGCACGATGAAGTTTTTCGGAATGTAAAGTGCTTTCAGTTGGGAAGAAAA--AAA-TGACGGTACCAACAGAAGAAGTGACGGCTAAATACGTG
Fusobacteria_ACTGTA-AACTATCAGAT	-TTAGCTAGTTGGAGAGGTAACGGCTCACCAAGGCGATGATGGGTAGCCGGCCTGAGAGGGTGATCGGCCACAAGGGGACTGAGACACGGCCCTTACTCCTACGGGAGGCAGCAGTGGGGAATATTGGACAATGG-AC--CAAGAGTCTGATCCAGCAATTCTGTGTGCACGATGAAGTTTTTCGGAATGTAAAGTGCTTTCAGTTGGGAAGAAAC--AAA-TGACGGTACCAACAGAAGAAGTGACGGCTAAATACGTG
Fusobacteria_ACTGTA-AACTATGAGAT	-TTAGCTAGTTGGAGAGGTAACGGCTCACCAAGGCGATGATGGGTAGCCGGCCTGAGAGGGTGATCGGCCACAAGGGGACTGAGACACGGCCCTTACTCCTACGGGAGGCAGCAGTGGGGAATATTGGACAATGG-AC--CAAGAGTCTGATCCAGCAATTCTGTGTGCACGATGAAGTTTTTCGGAATGTAAAGTGCTTTCAGTTGGGAAGAAAG--AAA-TGACGGTACCAACAGAAGAAGTGACGGCTAAATACGTG
Fusobacteria_ACTGTA-AACTATTAGAT	-TTAGCTAGTTGGAGAGGTAACGGCTCACCAAGGCGATGATGGGTAGCCGGCCTGAGAGGGTGATCGGCCACAAGGGGACTGAGACACGGCCCTTACTCCTACGGGAGGCAGCAGTGGGGAATATTGGACAATGG-AC--CAAGAGTCTGATCCAGCAATTCTGTGTGCACGATGAAGTTTTTCGGAATGTAAAGTGCTTTCAGTTGGGAAGAAAT--AAA-TGACGGTACCAACAGAAGAAGTGACGGCTAAATACGTG
Fusobacteria_ACTGTAAAGCTAT-AGAT	-TTAGCTAGTTGGAGAGGTAACGGCTCACCAAGGCGATGATGGGTAGCCGGCCTGAGAGGGTGAACGGCCACAAGGGGACTGAGACACGGCCCTTACTCCTACGGGAGGCAGCAGTGGGGAATATTGGACAATGG-ACCAAAA-G-TCTGATCCAGCAATTCTGTGTGCACGATGAAGTTTTTCGGAATGTAAAGTGCTTTCAGTTGGGAAGAA--G-AAAGTGACGGTACCAACAGAAGAAGTGACGGCTAAATACGTG
Fusobacteria_ACTGTAAAGCTCTAAGAT	-TTAGCTAGTTGGAGAGGTAACGGCTCACCAAGGCGATGATGGGTAGCCGGCCTGAGAGGGTGAACGGCCACAAGGGGACTGAGACACGGCCCTTACTCCTACGGGAGGCAGCAGTGGGGAATATTGGACAATGG-ACCAAAA-G-TCTGATCCAGCAATTCTGTGTGCACGATGACGTTTTTCGGAATGTAAAGTGCTTTCAGTTGGGAAGAAAA--AAA-TGACGGTACCAACAGAAGAAGTGACGGCTAAATACGTG
Fusobacteria_ACTGTAAGGCTATAAGAT	-TTAGCTAGTTGGAGAGGTAACGGCTCACCAAGGCGATGATGGGTAGCCGGCCTGAGAGGGTGAACGGCCACAAGGGGACTGAGACACGGCCCTTACTCCTACGGGAGGCAGCAGTGGGGAATATTGGACAATGG-ACCAAGA-G-TCTGATCCAGCAATTCTGTGTGCACGATGAAGTTTTTCGGAATGTAAAGTGCTTTCAGTTGGGAAGAAAA--AAA-TGACGGTACCAACAGAAGAAGTGACGGCTAAATACGTG
Fusobacteria_ACTGTAAGGCTCTAAGAT	-TTAGCTAGTTGGAGAGGTAACGGCTCACCAAGGCGATGATGGGTAGCCGGCCTGAGAGGGTGAACGGCCACAAGGGGACTGAGACACGGCCCTTACTCCTACGGGAGGCAGCAGTGGGGAATATTGGACAATGG-ACCAAGA-G-TCTGATCCAGCAATTCTGTGTGCACGATGACGTTTTTCGGAATGTAAAGTGCTTTCAGTTGGGAAGAAAA--AAA-TGACGGTACCAACAGAAGAAGTGACGGCTAAATACGTG
Fusobacteria_ACTGTAGGCCAAT-GGAC	ATTAGCTAGTTGGTAAGGTAACGGCTTACCAAGGCGATGATAGGTAGCCGGCCTGAGAGGGTGGACGGCCACAAGGGGACTGAGATACGGCCCTTACTCTTACGGGAGGCAGCAGTGGGGAATATTGGACAATGG-AG-GAGA-C-TCTGATCCAGCAATTCTGTGTGCACGAAGAAGGTTTTCGGATTGTAAAGTGCTTTCAGTGGGGAAGAA--G-GAAGTGACGGTACCCACAGAAGAAGCGACGGCTAAATACGTG
Fusobacteria_ACTGTAGGGCTATAAGAT	-TTAGCTAGTTGGAGAGGTAACAGCTCACCAAGGCGATGATGGGTAGCCGGCCTGAGAGGGTGAACGGCCACAAGGGGACTGAGACACGGCCCTTACTCCTACGGGAGGCAGCAGTGGGGAATATTGGACAATGG-ACCGAGA-G-TCTGATCCAGCAATTCTGTGTGCACGATGAAGTTTTTCGGAATGTAAAGTGCTTTCAGTTGGGAAGAAAA--AAA-TGACGGTACCAACAGAAGAAGTGACGGCTAAATACGTG
Fusobacteria_ACTGTAGGGCTATGAGAT	-TTAGCTAGTTGGAGAGGTAACAGCTCACCAAGGCGATGATGGGTAGCCGGCCTGAGAGGGTGAACGGCCACAAGGGGACTGAGACACGGCCCTTACTCCTACGGGAGGCAGCAGTGGGGAATATTGGACAATGG-ACCGAGA-G-TCTGATCCAGCAATTCTGTGTGCACGATGAAGTTTTTCGGAATGTAAAGTGCTTTCAGTTGGGAAGAAAG--AAA-TGACGGTACCAACAGAAGAAGTGACGGCTAAATACGTG
Fusobacteria_ACTGTAGGGCTATTAGAT	-TTAGCTAGTTGGAGAGGTAACAGCTCACCAAGGCGATGATGGGTAGCCGGCCTGAGAGGGTGAACGGCCACAAGGGGACTGAGACACGGCCCTTACTCCTACGGGAGGCAGCAGTGGGGAATATTGGACAATGG-ACCGAGA-G-TCTGATCCAGCAATTCTGTGTGCACGATGAAGTTTTTCGGAATGTAAAGTGCTTTCAGTTGGGAAGAAAT--AAA-TGACGGTACCAACAGAAGAAGTGACGGCTAAATACGTG
Fusobacteria_ACTGTCGGGCTATAAGAT	-TTAGCTAGTTGGAGAGGTAACGGCTCACCAAGGCGATGATGGGTAGCCGGCCTGAGAGGGTGATCGGCCACAAGGGGACTGAGACACGGCCCTTACTCCTACGGGAGGCAGCAGTGGGGAATATTGGACAATGGACC-GAGA-G-TCTGATCCAGCAATTCTGTGTGCACGATGAAGTTTTTCGGAATGTAAAGTGCTTTCAGTTGGGAAGAAAA--AAA-TGACGGTACCAACAGAAGAAGTGACGGCTAAATACGTG
Fusobacteria_ACTGTCGGGCTATCAGAT	-TTAGCTAGTTGGAGAGGTAACGGCTCACCAAGGCGATGATGGGTAGCCGGCCTGAGAGGGTGATCGGCCACAAGGGGACTGAGACACGGCCCTTACTCCTACGGGAGGCAGCAGTGGGGAATATTGGACAATGGACC-GAGA-G-TCTGATCCAGCAATTCTGTGTGCACGATGAAGTTTTTCGGAATGTAAAGTGCTTTCAGTTGGGAAGAAAC--AAA-TGACGGTACCAACAGAAGAAGTGACGGCTAAATACGTG
Fusobacteria_ACTGTCGGGCTATGAGAT	-TTAGCTAGTTGGAGAGGTAACGGCTCACCAAGGCGATGATGGGTAGCCGGCCTGAGAGGGTGATCGGCCACAAGGGGACTGAGACACGGCCCTTACTCCTACGGGAGGCAGCAGTGGGGAATATTGGACAATGGACC-GAGA-G-TCTGATCCAGCAATTCTGTGTGCACGATGAAGTTTTTCGGAATGTAAAGTGCTTTCAGTTGGGAAGAAAG--AAA-TGACGGTACCAACAGAAGAAGTGACGGCTAAATACGTG
Fusobacteria_ACTGTGGACCAAT-AGGC	ATTAGCTTGTTGGTGAGGTAACGGCTCACCAAGGCGATGATAGGTAGCCGGCCTGAGAGGGTGAACGGCCACAAGGGGACTGAGATACGGCCCTTACTCCTACGGGAGGCAGCAGTGGGGAATATTGGACAATGG-GG-GCAA-C-CCTGATCCAGCAATTCTGTGTGCACGAAGAAGGTTTTCGGATTGTAAAGTGCTTTCAGCAGGGAAGAA--G-AAAGTGACGGTACCTGCAGAAGAAGCGACGGCTAAATACGTG
Fusobacteria_ACTGTGGACCAAT-ATGC	ATTAGCTAGTTGGTAAGGTAACGGCTTACCAAGGCGATGATAGGTAGCCGGCCTGAGAGGGTGGACGGCCACAAGGGGACTGAGATACGGCCCTTACTCCTACGGGAGGCAGCAGTGGGGAATATTGGACAATGG-GG-GCAA-C-CCTGATCCAGCAATTCTGTGTGCACGAAGAAGGTTTTCGGATCGTAAAGTGCTTTCAGCAGGGAGGAA--G-AAAGTGACTGTACCTGCAGAAGAAGCGACGGCTAAATACGTG
Fusobacteria_AGTGAGGACCAAT-GGGC	ATTAGCTAGTTGGTGAGGTAAGGGCTCACCAAGGCGAAGATAGGTAGCCGGCCTGAGAGGGTGGACGGCCACAAGGGGACTGAGATACGGCCCTTACTCCTACGGGAGGCAGCAGTGGGGAATATTGGACAATGG-GG-GCAA-C-CCTGATCCAGCAATTCTGTGTGCACGAAGAAGGTTTTCGGATTGTAAAGTGCTTTCAGCAGGGAAGAA--G-GAAGTGACGGTACCTGCAGAAGAAGCGACGGCTAAATACGTG
Fusobacteria_ATCGTGGACCTATAAGGC	ATTAGCTTGTTGGTGGGGTAATGGCCCACCAAGGCGATGATAGGTAGCCGGCCTGAGAGGGTGGACGGCCACAAGGGGACTGAGATACGGCCCTTACTCCTACGGGAGGCAGCAGTGGGGAATATTGGACAATGG-GG-GCAA-C-CCTGATCCAGCAATTCTGTGTGCACGATGAAGGTTTTCGGATTGTAAAGTGCTTTCAGCAGGGAAGAAAA--AAA-TGACGGTACCTGCAGAAGAAGCGACGGCTAAATACGTG
Fusobacteria_ATTGAGGACCAAT-GGGC	ATTAGCTAGTTGGTGAGGTAATGGCTCACCAAGGCGAAGATAGGTAGCCGGCCTGAGAGGGTGGACGGCCACAAGGGGACTGAGATACGGCCCTTACTCCTACGGGAGGCAGCAGTGGGGAATATTGGACAATGG-GG-GCAA-C-CCTGATCCAGCAATTCTGTGTGCACGAAGAAGGTTTTCGGATTGTAAAGTGCTTTCAGCAGGGAAGAA--G-GAAGTGACGGTACCTGCAGAAGAAGCGACGGCTAAATACGTG
Fusobacteria_ATTGAGGACCAAT-TGGC	ATTAGCTAGTTGGTGAGGTAATGGCTCACCAAGGCGAAGATAGGTAGCCGGCCTGAGAGGGTGGACGGCCACAAGGGGACTGAGATACGGCCCTTACTCCTACGGGAGGCAGCAGTGGGGAATATTGGACAATGG-GG-GCAA-C-CCTGATCCAGCAATTCTGTGTGCACGAAGAAGGTTTTCGGATTGTAAAGTGCTTTCAGCAGGGAAGAA--G-TAAGTGACGGTACCTGCAGAAGAAGCGACGGCTAAATACGTG
Fusobacteria_ATTGTAGGCCAAT-GGAC	ATTAGCTAGTTGGTAAGGTAATGGCTTACCAAGGCGATGATAGGTAGCCGGCCTGAGAGGGTGGACGGCCACAAGGGGACTGAGATACGGCCCTTACTCTTACGGGAGGCAGCAGTGGGGAATATTGGACAATGG-AG-GAGA-C-TCTGATCCAGCAATTCTGTGTGCACGAAGAAGGTTTTCGGATTGTAAAGTGCTTTCAGTGGGGAAGAA--G-GAAGTGACGGTACCCACAGAAGAAGCGACGGCTAAATACGTG
Fusobacteria_GCTGTGGACCAAT-AGGC	ATTAGCTTGTTGGTGAGGTGACGGCTCACCAAGGCGATGATAGGTAGCCGGCCTGAGAGGGTGAACGGCCACAAGGGGACTGAGATACGGCCCTTACTCCTACGGGAGGCAGCAGTGGGGAATATTGGACAATGG-GG-GCAA-C-CCTGATCCAGCAATTCTGTGTGCACGAAGAAGGTTTTCGGATTGTAAAGTGCTTTCAGCAGGGAAGAA--G-AAAGTGACGGTACCTGCAGAAGAAGCGACGGCTAAATACGTG
Gammaproteobacteria_AGCATTGGCATCT	-AAAGGCCTACCAAGCCTGCGATCTCTAGCTGGTCTGAGAGGATGACCAGCCACACTGGAACTGAGACACGGTCCAGACTCCTACGGGAGGCAGCAG-TGGGGAATATTGCGCAATGGGGGGAACCCTGACGCAGCCATGCCGCGTGAATGAAGAAGGCCTTAGGGTTGTAAAGTTCTTTCGGTATTGAGGAA-GGTTGATGTGTTAATAGCACATCAAATTGACGTTAAATACAGAAGAAGCACCGGCTAACTCCGTG
Gammaproteobacteria_AGCCCCCAACAGT	-AAAGGCTCACCAAGCCGACGATCTCTAGCTGGTCTGAGAGGATGACCAGCCACACTGGGACTGAGACACGGCCCAGACTCCTACGGGAGGCAGCAG-TGGGGAATATTGCGCAATGGGGGCAACCCTGACGCAGCCATGCCGCGTGAATGAAGAAGGCCTTCGGGTTGTAAAGTTCTTTCGGTAGCGAGGAA-GGCACTTAGTTTAATAAACTAAGTGATTGACGTTAACTACAGAAGAAGCACCGGCTAACTCCGTG
Gammaproteobacteria_AGCCCCCAACGGT	-AAAGGCTCACCAAGCCGACGATCTCTAGCTGGTCTGAGAGGATGACCAGCCACACTGGGACTGAGACACGGCCCAGACTCCTACGGGAGGCAGCAG-TGGGGAATATTGCGCAATGGGGGCAACCCTGACGCAGCCATGCCGCGTGAATGAAGAAGGCCTTCGGGTTGTAAAGTTCTTTCGGTAGCGAGGAA-GGCACTTAGTTTAATAAACTAGGTGATTGACGTTAACTACAGAAGAAGCACCGGCTAACTCCGTG
Gammaproteobacteria_AGCCCCCGACGGT	-AAAGGCTCACCAAGCCGACGATCTCTAGCTGGTCTGAGAGGATGACCAGCCACACTGGGACTGAGACACGGCCCAGACTCCTACGGGAGGCAGCAG-TGGGGAATATTGCGCAATGGGGGCAACCCTGACGCAGCCATGCCGCGTGAATGAAGAAGGCCTTCGGGTTGTAAAGTTCTTTCGGTAGCGAGGAA-GGCACTTAGTTTAATAGACTAGGTGATTGACGTTAACTACAGAAGAAGCACCGGCTAACTCCGTG
Gammaproteobacteria_AGCCCCTAACAGT	-AAAGGCTCACCAAGCCGACGATCTCTAGCTGGTCTGAGAGGATGACCAGCCACACTGGGACTGAGACACGGCCCAGACTCCTACGGGAGGCAGCAG-TGGGGAATATTGCGCAATGGGGGCAACCCTGACGCAGCCATGCCGCGTGAATGAAGAAGGCCTTCGGGTTGTAAAGTTCTTTCGGTAGCGAGGAA-GGCATTTAGTTTAATAAACTAAGTGATTGACGTTAACTACAGAAGAAGCACCGGCTAACTCCGTG
Gammaproteobacteria_AGCCCCTAACGAT	-AAAGGCTCACCAAGCCGACGATCTCTAGCTGGTCTGAGAGGATGACCAGCCACACTGGGACTGAGACACGGCCCAGACTCCTACGGGAGGCAGCAG-TGGGGAATATTGCGCAATGGGGGCAACCCTGACGCAGCCATGCCGCGTGAATGAAGAAGGCCTTCGGGTTGTAAAGTTCTTTCGGTAGCGAGGAA-GGCATTTAGTTTAATAAACTGGATGATTGACGTTAACTACAGAAGAAGCACCGGCTAACTCCGTG
Gammaproteobacteria_AGCCCCTAACGGT	-AAAGGCTCACCAAGCCGACGATCTCTAGCTGGTCTGAGAGGATGACCAGCCACACTGGGACTGAGACACGGCCCAGACTCCTACGGGAGGCAGCAG-TGGGGAATATTGCGCAATGGGGGCAACCCTGACGCAGCCATGCCGCGTGAATGAAGAAGGCCTTCGGGTTGTAAAGTTCTTTCGGTAGCGAGGAA-GGCATTTAGTTTAATAAACTAGGTGATTGACGTTAACTACAGAAGAAGCACCGGCTAACTCCGTG
Gammaproteobacteria_AGCCCCTGACAGT	-AAAGGCTCACCAAGCCGACGATCTCTAGCTGGTCTGAGAGGATGACCAGCCACACTGGGACTGAGACACGGCCCAGACTCCTACGGGAGGCAGCAG-TGGGGAATATTGCGCAATGGGGGCAACCCTGACGCAGCCATGCCGCGTGAATGAAGAAGGCCTTCGGGTTGTAAAGTTCTTTCGGTAGCGAGGAA-GGCATTTAGTTTAATAGACTAAGTGATTGACGTTAACTACAGAAGAAGCACCGGCTAACTCCGTG
Gammaproteobacteria_AGCCCCTGACGAT	-AAAGGCTCACCAAGCCGACGATCTCTAGCTGGTCTGAGAGGATGACCAGCCACACTGGGACTGAGACACGGCCCAGACTCCTACGGGAGGCAGCAG-TGGGGAATATTGCGCAATGGGGGCAACCCTGACGCAGCCATGCCGCGTGAATGAAGAAGGCCTTCGGGTTGTAAAGTTCTTTCGGTAGCGAGGAA-GGCATTTAGTTTAATAGACTAGATGATTGACGTTAACTACAGAAGAAGCACCGGCTAACTCCGTG
Gammaproteobacteria_AGCCCCTGACGGT	-AAAGGCTCACCAAGCCGACGATCTCTAGCTGGTCTGAGAGGATGACCAGCCACACTGGGACTGAGACACGGCCCAGACTCCTACGGGAGGCAGCAG-TGGGGAATATTGCGCAATGGGGGCAACCCTGACGCAGCCATGCCGCGTGAATGAAGAAGGCCTTCGGGTTGTAAAGTTCTTTCGGTAGCGAGGAA-GGCATTTAGTTTAATAGACTAGGTGATTGACGTTAACTACAGAAGAAGCACCGGCTAACTCCGTG
Gammaproteobacteria_AGCCTATGCACAT	-AAAGGCCTACCAAGCCTGCGATCTCTAGCTGGTCTGAGAGGATGGCCAGCCACACTGGAACTGAGACACGGTCCAGACTCCTACGGGAGGCAGCAG-TGGGGAATATTGCGCAATGGGGGGAACCCTGACGCAGCCATGCCGCGTGAATGAAGAAGGCCTTCGGGTTGTAAAGTTCTTTCGGTATTGAGGAA-GGAGTGTATGTTAATAGCATACATTATTGACGTTAAATACAGAAGAAGCACCGGCTAACTCCGTG
Gammaproteobacteria_AGCCTCTGACGGT	-AAAGGCTCACCAAGCCGACGATCTCTAGCTGGTCTGAGAGGATGACCAGCCACACTGGGACTGAGACACGGCCCAGACTCCTACGGGAGGCAGCAG-TGGGGAATATTGCGCAATGGGGGCAACCCTGACGCAGCCATGCCGCGTGAATGAAGAAGGCCTTCGGGTTGTAAAGTTCTTTCGGTAGTGAGGAA-GGCATTTAGTTTAATAGACTAGGTGATTGACGTTAACTACAGAAGAAGCACCGGCTAACTCCGTG
Gammaproteobacteria_AGCCTGTGTATAT	-AAAGGCCTACCAAGCCTGCGATCTCTAGCTGGTCTGAGAGGATGGCCAGCCACACTGGAACTGAGACACGGTCCAGACTCCTACGGGAGGCAGCAG-TGGGGAATATTGCGCAATGGGGGGAACCCTGACGCAGCCATGCCGCGTGAATGAAGAAGGCCTTCGGGTTGTAAAGTTCTTTCGGTATTGAGGAA-GGGATGTGTGCTAATAGTACATATCATTGACGTTAAATACAGAAGAAGCACCGGCTAACTCCGTG
Gammaproteobacteria_AGCCTTGGTATCT	-AAAGGCCTACCAAGCCTGCGATCTCTAGCTGGTCTGAGAGGATGGCCAGCCACACTGGAACTGAGACACGGTCCAGACTCCTACGGGAGGCAGCAG-TGGGGAATATTGCGCAATGGGGGGAACCCTGACGCAGCCATGCCGCGTGAATGAAGAAGGCCTTCGGGTTGTAAAGTTCTTTCGGTATTGAGGAA-GGTTGATGTGTTAATAGTACATCAAATTGACGTTAAATACAGAAGAAGCACCGGCTAACTCCGTG
Gammaproteobacteria_AGTCCCTGACGGT	-AAAGGCTCACCAAGCCGACGATCTCTAGCTGGTCTGAGAGGATGACCAGCCACACTGGAACTGAGACACGGTCCAGACTCCTACGGGAGGCAGCAG-TGGGGAATATTGCACAATGGGGGGAACCCTGATGCAGCCATGCCGCGTGAATGAAGAAGGCCTTCGGGTTGTAAAGTTCTTTCGGTAGCGAGGAA-GGCATTTAGTTTAATAGACTAGGTGATTGACGTTAACTACAGAAGAAGCACCGGCTAACTCCGTG
Gammaproteobacteria_AGTCCTAGCATTC	-AAAGGCTGACCAAGCCGACGATCTCTAGCTGGTCTGAGAGGATGACCAGCCACACTGGAACTGAGACACGGTCCAGACTCCTACGGGAGGCAGCAG-TGGGGAATATTGCACAATGGGGGGAACCCTGATGCAGCCATGCCGCGTGAATGAAGAAGGCCTTCGGGTTGTAAAGTTCTTTCGGTGACGAGGAA-GGTTAATATGTTAATAGCATATTAAATTGACGTTAATCACAGAAGAAGCACCGGCTAACTCCGTG
Gammaproteobacteria_AGTCCTGGCATCC	-AAAGGCTGACCAAGCCGACGATCTCTAGCTGGTCTGAGAGGATGACCAGCCACACTGGAACTGAGACACGGTCCAGACTCCTACGGGAGGCAGCAG-TGGGGAATATTGCACAATGGGGGGAACCCTGATGCAGCCATGCCGCGTGAATGAAGAAGGCCTTCGGGTTGTAAAGTTCTTTCGGTGACGAGGAA-GGTTGGTATGTTAATAGCATATCAAATTGACGTTAATCACAGAAGAAGCACCGGCTAACTCCGTG
Gammaproteobacteria_AGTCCTGGCCTCC	-AAAGGCTGACCAAGCCGACGATCTCTAGCTGGTCTGAGAGGATGACCAGCCACACTGGAACTGAGACACGGTCCAGACTCCTACGGGAGGCAGCAG-TGGGGAATATTGCACAATGGGGGGAACCCTGATGCAGCCATGCCGCGTGAATGAAGAAGGCCTTCGGGTTGTAAAGTTCTTTCGGTGACGAGGAA-GGTTGATAGGTTAATAGCCTATCAAATTGACGTTAATCACAGAAGAAGCACCGGCTAACTCCGTG
Gammaproteobacteria_AGTCCTGGCGTCC	-AAAGGCTGACCAAGCCGACGATCTCTAGCTGGTCTGAGAGGATGACCAGCCACACTGGAACTGAGACACGGTCCAGACTCCTACGGGAGGCAGCAG-TGGGGAATATTGCACAATGGGGGGAACCCTGATGCAGCCATGCCGCGTGAATGAAGAAGGCCTTCGGGTTGTAAAGTTCTTTCGGTGACGAGGAA-GGTTGATATGTTAATAGCGTATCAAATTGACGTTAATCACAGAAGAAGCACCGGCTAACTCCGTG
Gammaproteobacteria_AGTCGTCC-CCGT	TAAAGGCCTACCAAGGCGACGATCCATAGCTGGTCTGAGAGGATGATCAGCCACACTGGGACTGAGACACGGCCCAGACTCCTACGGGAGGCAGCAG-TGGGGAATATTGGACAATGGGGGGAACCCTGATCCAGCAATGCCGCGTGTGTGAAGAAGGCCTTCGGGTTGTAAAGCACTTTCAGTAGGGAGGAAAGGTGCGTAG-TTAATAC-CTGCGCAATTGACGTTACCTACAGAAGAAGCACCGGCTAACTCCGTG
Gammaproteobacteria_AGTTGGTCCCAAC	-AAAGGCCTACCAAGGCGACGATCTGTAGCTGGTCTGAGAGGATGATCAGCCACACTGGGACTGAGACACGGCCCAGACTCCTACGGGAGGCAGCAGTGG-GGAATATTGGACAATGGGCGAAAGCCTGATCCAGCCATGCCGCGTGTGTGAAGAAGGCCTTTTGGTTGTAAAGCACTTTAAGTGGGGAGGAA-AAGCTTATGGTTAATACCCATAAGCCCTGACGTTACCCACAGAATAAGCACCGGCTAACTCTGTG
Gammaproteobacteria_ATCATTGGCATCT	-AAATGCCTACCAAGCCTGCGATCTCTAGCTGGTCTGAGAGGATGACCAGCCACACTGGAACTGAGACACGGTCCAGACTCCTACGGGAGGCAGCAG-TGGGGAATATTGCGCAATGGGGGGAACCCTGACGCAGCCATGCCGCGTGAATGAAGAAGGCCTTAGGGTTGTAAAGTTCTTTCGGTATTGAGGAA-GGTTGATGTGTTAATAGCACATCAAATTGACGTTAAATACAGAAGAAGCACCGGCTAACTCCGTG
Gammaproteobacteria_GGCCCCTGACGGT	-AAGGGCTCACCAAGCCGACGATCTCTAGCTGGTCTGAGAGGATGACCAGCCACACTGGGACTGAGACACGGCCCAGACTCCTACGGGAGGCAGCAG-TGGGGAATATTGCGCAATGGGGGCAACCCTGACGCAGCCATGCCGCGTGAATGAAGAAGGCCTTCGGGTTGTAAAGTTCTTTCGGTAGCGAGGAA-GGCATTTAGTTTAATAGACTAGGTGATTGACGTTAACTACAGAAGAAGCACCGGCTAACTCCGTG
Gammaproteobacteria_GGCCTTGGTATCT	-AAGGGCCTACCAAGCCTGCGATCTCTAGCTGGTCTGAGAGGATGGCCAGCCACACTGGAACTGAGACACGGTCCAGACTCCTACGGGAGGCAGCAG-TGGGGAATATTGCGCAATGGGGGGAACCCTGACGCAGCCATGCCGCGTGAATGAAGAAGGCCTTCGGGTTGTAAAGTTCTTTCGGTATTGAGGAA-GGTTGATGTGTTAATAGTACATCAAATTGACGTTAAATACAGAAGAAGCACCGGCTAACTCCGTG
Spirochaetes_CCATAAAAAGACTGATG	-GCCCACCAAGGCAACGATGGGTATCCGGCCTGAGAGGGTGAACGGACACATTGGGACTGAGATACGGCCCAAACTCCTACGGGAGGCAGCAGCTAAGAATCTTCCGCAATGGACGAAAGTCTGACGGAGCGACGCCGTGTGAATGAAGAAGGCCGAAAGGTTGTAAAATTCTTTTGCAGATGAAGAATAAGAAGAAGAGGGAA-TGCTTCTTTGATGACGGTAA-TCATGCGAATAAGCCCCGGCTAATTACGTG
Spirochaetes_CCATAAAAAGACTGGTG	-GCCCACCAAGGCAACGATGGGTATCCGGCCTGAGAGGGTGAACGGACACATTGGGACTGAGATACGGCCCAAACTCCTACGGGAGGCAGCAGCTAAGAATCTTCCGCAATGGACGAAAGTCTGACGGAGCGACGCCGTGTGAATGAAGAAGGCCGAAAGGTTGTAAAATTCTTTTGCAGATGAAGAATAAGAAGAAGAGGGAA-TGCTTCTTTGATGACGGTAG-TCATGCGAATAAGCCCCGGCTAATTACGTG
Spirochaetes_CCGCAAAACTAGAGGCA	GGCCCGCCGTGGCGAGGACGGGTATCCGGCCTGAGAGGGCGGACGGACACATTGGGACTGAGATACGGCCCAGACTCCTACGGGAGGCAGCAGGTAAGAATATTCCGCAATGGGGGAAACCCTGACGGAGCGACGCCGCGTGAACGAAGAAGGCCGGAAGGTTGTAAAGTTCTTTTCTGTCCGAGGAATAAGTGTAGGAGGAAA-TGCCTGCATGGTGACGGTAG-GG-CAGGAATAAGCACCGGCTAATTACGTG
Spirochaetes_CCGCAAAACTCAAGGCA	AGCCCGCCGTGGCGAGGACGGGTATCCGGCCTGAGAGGGCGGACGGACACATTGGGACTGAGATACGGCCCAGACTCCTACGGGAGGCAGCAGGTAAGAATATTCCGCAATGGGGGAAACCCTGACGGAGCGACGCCGCGTGAACGAAGAAGGCCGGAAGGTTGTAAAGTTCTTTTCTGTCCGAGGAATAAGTGTCGGAGGGAA-TGCCGACACGGTGACGGTAG-GG-CAGGAATAAGCACCGGCTAATTACGTG
Spirochaetes_CCGCAAAACTTAAGGCA	GGCCCGCCGTGGCGAGGACGGGTATCCGGCCTGAGAGGGCGGACGGACACATTGGGACTGAGATACGGCCCAGACTCCTACGGGAGGCAGCAGGTAAGAATATTCCGCAATGGGGGAAACCCTGACGGAGCGACGCCGCGTGAACGAAGAAGGCCGGAAGGTTGTAAAGTTCTTTTCTGTCCGAGGAATAAGTGTTGGAGGAAA-TGCCGACATGGTGACGGTAG-GG-CAGGAATAAGCACCGGCTAATTACGTG
Spirochaetes_CCGCAAGACTAGAGGCA	GGCCCGCCGTGGCGAGGACGGGTATCCGGCCTGAGAGGGCGGACGGACACATTGGGACTGAGATACGGCCCAGACTCCTACGGGAGGCAGCAGGTAAGAATATTCCGCAATGGGGGGAACCCTGACGGAGCGACGCCGCGTGAACGAAGAAGGCCGGAAGGTTGTAAAGTTCTTTTCTGTCCGAGGAATAAGTGTAGGAGGAAA-TGCCTGCATGGTGACGGTAG-GG-CAGGAATAAGCACCGGCTAATTACGTG
Spirochaetes_CCGCAAGACTCGAGGCA	GGCCCGCCGTGGCGAGGACGGGTATCCGGCCTGAGAGGGCGGACGGACACATTGGGACTGAGATACGGCCCAGACTCCTACGGGAGGCAGCAGGTAAGAATATTCCGCAATGGGGGGAACCCTGACGGAGCGACGCCGCGTGAACGAAGAAGGCCGGAAGGTTGTAAAGTTCTTTTCTGTCCGAGGAATAAGTTTCGGAGGAAA-TGCCGGGACGGTGACGGTAG-GG-CAGGAATAAGCACCGGCTAATTACGTG
Spirochaetes_CCGCAAGATTAAAGGCA	TGCCCGCCGTGGCGAGGACGGGTATCCGGCCTGAGAGGGCGGACGGACACATTGGGACTGAGATACGGCCCAGACTCCTACGGGAGGCAGCAGGTAAGAATATTCCGCAATGGGGGGAACCCTGACGGAGCGACGCCGCGTGAACGAAGAAGGCCGGAAGGTTGTAAAGTTCTTTTCTGTTCGAGGAATAAGTGTAGGAGGAAA-TGCCTACATGGTGACGGTAG-GG-CAGGAATAAGCACCGGCTAATTACGTG
Spirochaetes_CCGCAAGATTCGAGGCA	GGCCCGCCGTGGCGAGGACGGGTATCCGGCCTGAGAGGGCGGACGGACACATTGGGACTGAGATACGGCCCAGACTCCTACGGGAGGCAGCAGGTAAGAATATTCCGCAATGGGGGGAACCCTGACGGAGCGACGCCGCGTGAACGAAGAAGGCCGGAAGGTTGTAAAGTTCTTTTCTGTTCGAGGAATAAGTTTCGGAGGAAA-TGCCGGGACGGTGACGGTAG-GG-CAGGAATAAGCACCGGCTAATTACGTG
Spirochaetes_CCGTAAAAAGGCCGAGG	GGCCCACCAAGGCGACGATGGGTATCCGGCCTGAGAGGGTGAACGGACACATTGGGACTGAGATACGGCCCAAACTCCTACGGGAGGCAGCAGCTAAGAATATTCCGCAATGGACGAAAGTCTGACGGAGCGACGCCGCGTGGATGAAGAAGGCTGAAAAGTTGTAAAATCCTTTTGTTGATGAAGAATAAGGGGGAGAGGGAA-TGCTTCTCTGATGACGGTAA-TC-GGCGAATAAGCCCCGGCTAATTACGTG
Spirochaetes_CCGTAAAACCAGGCGCT	GGCCCACCAAGGCGATGATGGGTATCCGGCCTGAGAGGGTGAACGGACACATTGGGACTGAGATACGGCCCAGACTTCTACGGGAGGCAGCAGTTAAGAATATTCCGCAATGGACGAAAGTCTGACGGAGCGACGCCGCGTGGATGAAGAATGCCGAAAGGTTGTAAAATCCTTTTAAGCCTGATGAATAAGCACAATAGGGAA-TGATTGTGCGGTGACCGTAG-GG-CTTGAATAAGCACCGGCTAATTACGTG
Spirochaetes_CCGTAAAACCAGGTGCT	GGCCCACCAAGGCGATGATGGGTATCCGGCCTGAGAGGGTGGACGGACACATTGGGACTGAGATACGGCCCAGACTTCTACGGGAGGCAGCAGTTAAGAATATTCCGCAATGGACGAAAGTCTGACGGAGCGACGCCGCGTGGATGAAGAATGCCGAAAGGTTGTAAAATCCTTTTAAGCCTGAGGAATAAGCACAGTAGGGAA-TGATTGTGTGGTGACTGTAG-GG-CTTGAATAAGCACCGGCAAATTACGTG
Spirochaetes_CCGTAACACCAGGCGCT	GGCCCACCAAGGCGATGATGGGTATCCGGCCTGAGAGGGTGAACGGACACATTGGGACTGAGATACGGCCCAGACTTCTACGGGAGGCAGCAGTTAAGAATATTCCGCAATGGACGCAAGTCTGACGGAGCGACGCCGCGTGGATGAAGAATGCCGAAAGGTTGTAAAATCCTTTTAAGCCTGATGAATAAGCACAATAGGGAA-TGATTGTGCGGTGACCGTAG-GG-CTTGAATAAGCACCGGCTAATTACGTG
Spirochaetes_CCGTAAGAATAACGAAG	GGCCCACCAAGGCGACGATGGGTATCCGGCCTGAGAGGGTGAACGGACACATTGGGACTGAGATACGGCCCAAACTCCTACGGGAGGCAGCAGCTAAGAATATTCCGCAATGGACGGAAGTCTGACGGAGCGACGCCGCGTGGATGAAGAAGGCTGAAAAGTTGTAAAATCCTTTTGTTGATGAAGAATAAGGATAAGAGGGAA-TGCTTATCTGATGACGGTAA-TC-AGCGAATAAGCCCCGGCTAATTACGTG
Spirochaetes_CCGTAAGAATGACGAGA	GGCCCACCAAGGCGACGATGGGTATCCGGCCTGAGAGGGTGAACGGACACATTGGGACTGAGATACGGCCCAAACTCCTACGGGAGGCAGCAGCTAAGAATATTCCGCAATGGACGGAAGTCTGACGGAGCGACGCCGCGTGGATGAAGAAGGCTGAAAAGTTGTAAAATCCTTTTGTTGATGAAGAATAAGGGTGAGAGGGAA-TGCTCATCTGATGACGGTAA-TC-GACGAATAAGCCCCGGCTAATTACGTG
Spirochaetes_CCGTAAGAATGACGAGG	GGCCCACCAAGGCGACGATGGGTATCCGGCCTGAGAGGGTGAACGGACACATTGGGACTGAGATACGGCCCAAACTCCTACGGGAGGCAGCAGCTAAGAATATTCCGCAATGGACGGAAGTCTGACGGAGCGACGCCGCGTGGATGAAGAAGGCTGAAAAGTTGTAAAATCCTTTTGTTGATGAAGAATAAGGGTGAGAGGGAA-TGCTCATCTGATGACGGTAA-TC-GGCGAATAAGCCCCGGCTAATTACGTG
Spirochaetes_CCGTAGAACTGGAAGCA	-GCCCACCAAGGCGATGATAGCTACCCGGCCTAAGAGGGTGAACGGGCACATTGGGACTGAGATACGGCCCAGACTCCTACGGGAGGCAGCAGCTAAGAATATTCCGCAATGGACGAAAGTCTGACGGAGCGACGCCGCGTGGATGATGAAGGTCGGAAGATTGTAAAATCCTTTTATGACTGAAGAATAAGTATGGTGAGAGAAACGCCGTATGGTGACAGTAG-GT-CATGAATAAGCAACGGCTAATTACGTG
Spirochaetes_CCGTTAAAAGACCGAAG	GGCCCACCAAGGCGACGATGGGTATCCGGCCTGAGAGGGTGATCGGACACATTGGGACTGAGATACGGCCCAAACTCCTACGGGAGGCAGCAGCTAAGAATATTCCGCAATGGACGAAAGTCTGACGGAGCGACGCCGCGTGGATGAAGAAGGCTGAAAAGTTGTAAAATCCTTTTGTTGATGAAGAATAAGGGGAAGAGGGAA-TGCTTCTCTGATGACGGTAA-TC-AGCGAATAAGCCCCGGCTAATTACGTG
Spirochaetes_CCGTTAGAAGACCGAAG	GGCCCACCAAGGCGACGATGGGTATCCGGCCTGAGAGGGTGATCGGACACATTGGGACTGAGATACGGCCCAAACTCCTACGGGAGGCAGCAGCTAAGAATATTCCGCAATGGACGGAAGTCTGACGGAGCGACGCCGCGTGGATGAAGAAGGCTGAAAAGTTGTAAAATCCTTTTGTTGATGAAGAATAAGGGGAAGAGGGAA-TGCTTCTCTGATGACGGTAA-TC-AGCGAATAAGCCCCGGCTAATTACGTG
Spirochaetes_CCGTTAGAATGACGAGA	GGCCCACCAAGGCGACGATGGGTATCCGGCCTGAGAGGGTGATCGGACACATTGGGACTGAGATACGGCCCAAACTCCTACGGGAGGCAGCAGCTAAGAATATTCCGCAATGGACGGAAGTCTGACGGAGCGACGCCGCGTGGATGAAGAAGGCTGAAAAGTTGTAAAATCCTTTTGTTGATGAAGAATAAGGGTGAGAGGGAA-TGCTCATCTGATGACGGTAA-TC-GACGAATAAGCCCCGGCTAATTACGTG
Spirochaetes_CTATAAAAAGACTGGTG	-GCCTACCAAGGCAACGATGGGTATCCGGCCTGAGAGGGTGAACGGACACATTGGGACTGAGATACGGCCCAAACTCCTACGGGAGGCAGCAGCTAAGAATCTTCCGCAATGGACGAAAGTCTGACGGAGCGACGCCGTGTGAATGAAGAAGGCCGAAAGGTTGTAAAATTCTTTTGCAGATGAAGAATAAGAAGAAGAGGGAA-TGCTTCTTTGATGACGGTAG-TCATGCGAATAAGCCCCGGCTAATTACGTG
Spirochaetes_CTATAGAAATAACGGTG	-GCCTACCAAGGCAACGATGGGTACCCGGCCTGAGAGGGTGAACGGGCACATTGGGACTGAGATACGGCCCAAACTCCTACGGGAGGCAGCAGCTGAGAATCTTCCGCAATGGACGAAAGTCTGACGGAGCGACACCGCGTGAACGATGAAGGCCGAAAGGTTGTAAAGTTCTTTTGCAGACAAAGAATAAGGATAGAAGGAAA-TGACTATCTGATGACGGTAG-TTATGCGAATAAGCCCCGGCTAATTACGTG
Spirochaetes_CTGTAAAAATAACGGTG	-GCCTACCAAGGCGACGATGGGTATCCGGCCTGAGAGGGTGAACGGACACATTGGGACTGAGATACGGCCCAAACTCCTACGGGAGGCAGCAGCTGAGAATCTTCCGCAATGGACGAAAGTCTGACGGAGCGACACCGCGTGAACGATGAAGGCCGGAAGGTTGTAAAGTTCTTTTGCAGACAAAGAATAAGGATAGAAGGAAA-TGACTATCTGATGACGGTAG-TTATGCGAATAAGCCCCGGCTAATTACGTG
Spirochaetes_CTGTAAAAGTAATGGGA	GGCCTGCCGAGGCGACGACGGGTATCCGGCCTGAGAGGGTGGACGGACACATTGGGACTGAGATACGGCCCAGACTCCTACGGGAGGCAGCAGCTAAGAATATTCCGCAATGGACGAAAGTCTGACGGAGCGACGCCGCGTGGATGATGAAGGCCGGAAGGTTGTAAAGTCCTTTTATCCGTGAAGAAGAAGATTAAGAGGGAA-TGCTTAATTGGTGACGGTAG-CG-GATGAATAAGCACCGGCTAATTACGTG
Spirochaetes_CTGTAAGAAATTAGGTA	GGCCTACCAAGGCGACGACGGGTATCCGGCCTGAGAGGGTGAACGGACACATTGGGACTGAGATACGGCCCAGACTCCTACGGGAGGCAGCAGCTAAGAATATTCCGCAATGGGGGGAACCCTGACGGAGCGACGCCGCGTGGACGATGAAGGTCGGAAGATTGTAAAGTCCTTTTATACATGAAGAAGAAGTTATACAGGAAA-TGGTATGATGGTGACGGTAG-TG-TATGAATAAGCACCGGCTAATTACGTG
Spirochaetes_CTGTTAGAAGACCGAGG	GGCCTACCAAGGCGACGATGGGTATCCGGCCTGAGAGGGTGATCGGACACATTGGGACTGAGATACGGCCCAAACTCCTACGGGAGGCAGCAGCTAAGAATATTCCGCAATGGACGGAAGTCTGACGGAGCGACGCCGCGTGGATGAAGAAGGCTGAAAAGTTGTAAAATCCTTTTGTTGATGAAGAATAAGGGGAAGAGGGAA-TGCTTCTCTGATGACGGTAA-TC-GGCGAATAAGCCCCGGCTAATTACGTG
Spirochaetes_GTGTCACATGTCGGACT	GGCGTACCAAGGCGACGATGGGTATCCGACCTGAGAGGGTGACCGGACACATTGGGACTGAGACACAGCCCAGACTCCTACGGGAGGCAGCAGCTAAGAATCTTCCGCAATGGGCGCAAGCCTGACGGAGCGACGCCGCGTGAATGAAGAAGGCCGAAAGGTTGTAAAATTCTTTTAAGTTTGAAGAATAACCAGTATAGGGAA-TGATACTGAGATGACGGTAA-AA-CTTGAATAAGCCCCGGCTAATTACGTG
Spirochaetes_TCATAAAAAGACTGATG	-GCTCACCAAGGCAACGATGGGTATCCGGCCTGAGAGGGTGAACGGACACATTGGGACTGAGATACGGCCCAAACTCCTACGGGAGGCAGCAGCTAAGAATCTTCCGCAATGGACGAAAGTCTGACGGAGCGACGCCGTGTGAATGAAGAAGGCCGAAAGGTTGTAAAATTCTTTTGCAGATGAAGAATAAGAAGAAGAGGGAA-TGCTTCTTTGATGACGGTAA-TCATGCGAATAAGCCCCGGCTAATTACGTG
Spirochaetes_TCATAAAAATAGGGATG	-GCTCACCAAGGCAACGATGGGTATCCGGCCTGAGAGGGTGAACGGACACATTGGGACTGAGATACGGCCCAAACTCCTACGGGAGGCAGCAGCTAAGAATCTTCCGCAATGGACGAAAGTCTGACGGAGCGACGCCGTGTGAATGAAGAAGGCCGAAAGGTTGTAAAATTCTTTTGCAGATGAAGAATAAACATAGGAGGGAA-TGCCTGTGAGATGACGGTAATCA-TGCGAATAAGCCCCGGCTAATTACGTG
Spirochaetes_TCATAAAGAGACTGATG	-GCTCACCAAGGCAACGATGGGTATCCGGCCTGAGAGGGTGAACGGACACATTGGGACTGAGATACGGCCCAAACTCCTACGGGAGGCAGCAGCTAAGAATCTTCCGCAATGGACGAAAGTCTGACGGAGCGACGCCGTGTGAATGAAGAAGGCCGAAAGGTTGTAAGATTCTTTTGCAGATGAAGAATAAGAAGAAGAGGGAA-TGCTTCTTTGATGACGGTAA-TCATGCGAATAAGCCCCGGCTAATTACGTG
Spirochaetes_TCATTAAAATAACGAAG	GGCTCACCAAGGCAACGATGGGTATCCGGCCTGAGAGGGTGATCGGACACATTGGGACTGAGATACGGCCCAAACTCCTACGGGAGGCAGCAGCTAAGAATATTCCGCAATGGACGAAAGTCTGACGGAGCGACGCCGCGTGGATGAAGAAGGCTGAAAAGTTGTAAAATCCTTTTGTTGATGAAGAATAAGGATAAGAGGGAA-TGCTTATCTGATGACGGTAA-TC-AGCGAATAAGCCCCGGCTAATTACGTG
Spirochaetes_TCGCAAGACTAGAGGCA	AGCTCACCAAGGCGAGGACGGGTATCCGGCCTGAGAGGGCGGACGGACACATTGGGACTGAGATACGGCCCAGACTCCTACGGGAGGCAGCAGGTAAGAATATTCCGCAATGGGGGGAACCCTGACGGAGCGACGCCGCGTGAACGAAGAAGGCCGGAAGGTTGTAAAGTTCTTTTCTGTCCGAGGAATAAGTGTAGGAGGAAA-TGCCTGCATGGTGACGGTAG-GG-CAGGAATAAGCACCGGCTAATTACGTG
Spirochaetes_TCGCAAGATTCAAGGCA	AGCTCACCAAGGCGAGGACGGGTATCCGGCCTGAGAGGGCGGACGGACACATTGGGACTGAGATACGGCCCAGACTCCTACGGGAGGCAGCAGGTAAGAATATTCCGCAATGGGGGGAACCCTGACGGAGCGACGCCGCGTGAACGAAGAAGGCCGGAAGGTTGTAAAGTTCTTTTCTGTTCGAGGAATAAGTGTCGGAGGAAA-TGCCGACATGGTGACGGTAG-GG-CAGGAATAAGCACCGGCTAATTACGTG
Spirochaetes_TCGTAAGAATAGCGAGG	GGCTCACCAAGGCGACGATGGGTATCCGGCCTGAGAGGGTGAACGGACACATTGGGACTGAGATACGGCCCAAACTCCTACGGGAGGCAGCAGCTAAGAATATTCCGCAATGGACGGAAGTCTGACGGAGCGACGCCGCGTGGATGAAGAAGGCTGAAAAGTTGTAAAATCCTTTTGTTGATGAAGAATAAGGGTAAGAGGGAA-TGCTTGCCTGATGACGGTAA-TC-GGCGAATAAGCCCCGGCTAATTACGTG
Spirochaetes_TCGTAAGAATGACGAGA	GGCTCACCAAGGCGACGATGGGTATCCGGCCTGAGAGGGTGAACGGACACATTGGGACTGAGATACGGCCCAAACTCCTACGGGAGGCAGCAGCTAAGAATATTCCGCAATGGACGGAAGTCTGACGGAGCGACGCCGCGTGGATGAAGAAGGCTGAAAAGTTGTAAAATCCTTTTGTTGATGAAGAATAAGGGTGAGAGGGAA-TGCTCATCTGATGACGGTAA-TC-GACGAATAAGCCCCGGCTAATTACGTG
Spirochaetes_TCGTTAGAATGACGAGA	GGCTCACCAAGGCGACGATGGGTATCCGGCCTGAGAGGGTGATCGGACACATTGGGACTGAGATACGGCCCAAACTCCTACGGGAGGCAGCAGCTAAGAATATTCCGCAATGGACGGAAGTCTGACGGAGCGACGCCGCGTGGATGAAGAAGGCTGAAAAGTTGTAAAATCCTTTTGTTGATGAAGAATAAGGGTGAGAGGGAA-TGCTCATCTGATGACGGTAA-TC-GACGAATAAGCCCCGGCTAATTACGTG
TM7_AGCGCCGCGCTAATT	AGGTAAAGGCTCACCAAGCCGACGATCCGTAGCTGGTCTGAGAGGATGATCAGCCAGACTGGGACTGAGACACGGCCCAGACTCCTACGGGAGGCAGCAGTGAGGAATCTTCCACAATGGGCGAAAGCCTGATGGAGCAACGCCGCGTGCAGGATGAAGGCCTTCGGGTTGTAAACTGCTTTTATAAGTGAGGAATATGACGGTAACTTATGAATAAGGATCGGCTAACTACGTG
TM7_AGCGCGTCGCTAATT	AGGTAAAGGCTCACCAAGTCGACGATCGTTAGATGGTTTGAGAGGATGATCATCCAGACTGGGACTGAGACACGGCCCAGACTCCTACGGGAGGCAGCAGTAGGGAATCTTTCACAATGGGCGAAAGCCTGATGGAGCAACGCCGCGTGCAGGATGAAGGCCTTCGGGTTGTAAACTGCTTTTATAAGCGAGAAATATGATGGTAACTTATGAATAAGGATCGGCTAACTACGTG
TM7_AGCGCGTCGTCAATT	AGGTAAAGGCTCACCAAGTCGACGATCGTTAGATGGTTTGAGAGGATGATCATCCAGACTGGGACTGAGACACGGCCCAGACTCCTACGGGAGGCAGCAGTAGGGAATCTTTCACAATGGGCGAAAGCCTGATGGAGCAATGCCGCGTGCAGGACGAAGGCCTTCGGGTTGTAAACTGCTTTTATAAGCGAGAAATATGATGGTAACTTATGAATAAGGATCGGCTAACTACGTG
TM7_AGCGCGTCGTTAATT	AGGTAAAGGCTCACCAAGTCGACGATCGTTAGATGGTTTGAGAGGATGATCATCCAGACTGGGACTGAGACACGGCCCAGACTCCTACGGGAGGCAGCAGTAGGGAATCTTTCACAATGGGCGAAAGCCTGATGGAGCAATGCCGCGTGCAGGATGAAGGCCTTCGGGTTGTAAACTGCTTTTATAAGCGAGAAATATGATGGTAACTTATGAATAAGGATCGGCTAACTACGTG
TM7_TGCGCCGCGCTAATT	AGGTAATGGCTCACCAAGCCGACGATCCGTAGCTGGTCTGAGAGGATGATCAGCCAGACTGGGACTGAGACACGGCCCAGACTCCTACGGGAGGCAGCAGTGAGGAATCTTCCACAATGGGCGAAAGCCTGATGGAGCAACGCCGCGTGCAGGATGAAGGCCTTCGGGTTGTAAACTGCTTTTATAAGTGAGGAATATGACGGTAACTTATGAATAAGGATCGGCTAACTACGTG
TM7_TGCGCCGTGCCAATT	AGGTAATGGCTCACCAAGCCGACGATCCGTAGCTGGTCTGAGAGGATGACCAGCCAGACTGGAACTGAGACACGGTCCAGACTCCTACGGGAGGCAGCAGTGAGGAATCTTCCACAATGGGCGAAAGCCTGATGGAGCAACGCCGCGTGCAGGACGAAGGCCTTCGGGTTGTAAACTGCTTTTATAAGTGAGGAATATGACGGTAACTTATGAATAAGGATCGGCTAACTACGTG
TM7_TGCGCCGTGCTAGCT	AGGTAATGGCTCACCAAGCCGACGATCCGTAGCTGGTCTGAGAGGATGACCAGCCAGACTGGAACTGAGACACGGTCCAGACTCCTACGGGAGGCAGCAGTGAGGAATCTTCCACAATGGGCGAAAGCCTGATGGAGCAACGCCGCGTGCAGGATGAAGGCCTTCGGGTTGTAAACTGCTTTTATGATTGAGGAATTTGACAGTAGATCATGAATAAGGATCGGCTAACTACGTG
TM7_TGCGCCGTGCTAGTT	AGGTAATGGCTCACCAAGCCGACGATCCGTAGCTGGTCTGAGAGGATGACCAGCCAGACTGGAACTGAGACACGGTCCAGACTCCTACGGGAGGCAGCAGTGAGGAATCTTCCACAATGGGCGAAAGCCTGATGGAGCAACGCCGCGTGCAGGATGAAGGCCTTCGGGTTGTAAACTGCTTTTATAAGTGAGGAATATGACGGTAGCTTATGAATAAGGATCGGCTAACTACGTG
TM7_TGTACTATGCTAACC	GGGTAATGGCCTACCAAGCCAACGATCTATAGCTGGTCTGAGAGGATGATCAGCCAGACTGGAACTGAGACACGGTCCAGACTCCTACGGGAGGCAGCAGTGAGGAATCTTCCACAATGGGCGAAAGCCTGATGGAGCAACGCCGCGTGAAGGATGAAGGCCTTCGGGTTGTAAACTTCTTTTATGAGTGAAGAATATGACGGTAACTCATGAATAAGCACCGGCTAACTACGTG
TM7_TGTACTTTGCTAATT	GGGTAATGGCCTACCAAGTCAACGATCTTTAACTGGTTTGAGAGGATGATCAGTCAGACTGGAACTGAGACACGGTCCAGACTCCTACGGGAGGCAGCAGTGAGGAATCTTCCACAATGGGCGAAAGCCTGATGGAGCAACGCCGCGTGCAGGATGAAGGCCTTCGGGTTGTAAACTGCTTTTATAAGTGAGGAATATGACAGTAACTTATGAATAAGGATCGGCTAACTACGTG
TM7_TGTGCCATGCTAACC	GGGTAATGGCCTACCAAGCCGACGATCCATAGCTGGTCTGAGAGGATGATCAGCCAGACTGGAACTGAGACACGGTCCAGACTCCTACGGGAGGCAGCAGTGAGGAATCTTCCACAATGGGCGAAAGCCTGATGGAGCAACGCCGCGTGAAGGATGAAGGCCTTCGGGTTGTAAACTTCTTTTATGAGTGAAGAATATGACGGTAACTCATGAATAAGCACCGGCTAACTACGTG
TM7_TGTGCTTTGCTTATT	GGGTAATGGCCTACCAAGTCGACGATCTTTAACTGGTTTGAGAGGATGATCAGTCAGACTGGAACTGAGACACGGTCCAGACTCCTACGGGAGGCAGCAGTGAGGAATCTTCCACAATGGGCGAAAGCCTGATGGAGCAACGCCGCGTGCAGGATGAAGGCCTTCGGGTTGTAAACTGCTTTTATAAGTGAGGATTATGACAGTAACTTATGAATAAGGATCGGCTAACTACGTG
TM7_TGTGTTGTGTTTATA	AGGTAATGGCTTACCAAGTCGATGATGTGTAGCTGGTCTGAGAGGATGATCAGCCAGACTGGAACTGAGACACGGTCCAGACTCCTACGGGAGGCAGCAGTGAGGAATATTTCACAATGAGCGAAAGCTTGATGGAGCAATGCCGCGTGCAGGATGAAGGCCCTCGGGTTGTAAACTGCTTTTATAAGAGAAGATTATGACGGTAACTTATGAATAAGGGACGGCTAACTACGTG
